ああ、あれですね。	啊，是那个啊。
にある	在……
まあまあよい。	还算行。
ああ！鯀かな！	於！鲧哉！
ああ、あなたでしたか。	啊，是你啊。
あらら。	哎呀。
あらまぁ	哎呀
あなたも。	你也。
あの夜……	那晚……
じゃあね。	再见。
あら、まぁ。	哎呀。
黒あざ．	黑记
ある人．	某人
あやつ．	那厮
制約がありあす。	有制约。
ありがとう、あんた。	谢谢你。
穴．	眼儿
ああ，わかりました．	噢，我懂了。
あと幾らあるか？	还余若干？
ああ！悲しいかな！	嘻！悲夫！
あそこ，あちら．≒那壁．≦那边．	那厢
顔にあざがある．	脸上有个痣。
雨があがった。	雨停了。
あの後	在那之后
ある場合	某种情况
ある朝	某天早上
安楽である．	晏乐
まあ焦るな！	你先别着急！
あなたにあげたいものがあります。	有想要给你的东西。
まあまあ親しみのあるAAA	有一点亲切感的AAA
あなたにあやまることがあります。	有向你道歉的事。
字はまあまあ上手に書いてある．	字写得还不错。
暮らし向きはまあまあである．	日子过得马马虎虎。
多義である，意味があいまいである．	有歧义
ああ！あなたも心の優しい人だ！	啊！你也是个软心肠！
あなたを愛してる。	我爱你。
アレルギーがある。	有过敏。
ドアがあきません。	门打不开。
あなたに謝る。	我向你道歉。
あなたに会いたい。	我想见你。
あなたを愛します。	我爱你。
心に穴があく。	心里有个洞。
雨あがったね！	雨停了啊！
ユーモアがある。	有幽默感。
空きありますか？	有空吗？
あまり会えない	不怎么能见到
さあ立ち上がれ。	站起来！
会ったことがある	看到过。
最愛のあなた	最亲爱的你
あなたに呆れる。	我受够你了。
『阿Q正伝』	《阿正传》
魯迅の『阿Q正伝』は，国内はおろか，国外でもたいへん有名である．	鲁迅的《阿正传》，别说［是］在国内，就是国外也是很有名的。
『阿Q正伝』は辛亥革命前後の農村の複雑な背景をはっきりと示している．	《阿正传》展示了辛亥革命前后农村的复杂背景。
ああ、あれですね。	啊，是那个啊。
ああ、あなたでしたか。	啊，是你啊。
ああ！鯀かな！	於！鲧哉！
ああ！あなたも心の優しい人だ！	啊！你也是个软心肠！
ああ，わかりました．	噢，我懂了。
ああ！悲しいかな！	嘻！悲夫！
ああ、彼らは美しい。	啊！他们太美了！
ああ、へとへとだよ。	啊，筋疲力尽了。
ああ、ご親切にどうも！	啊，谢谢您的好意！
ああ、どうしましょう。	啊，怎么办呀。
ああ…それは残念だわ。	啊啊…那很遗憾啊。
ああ、いっしょに行くよ。	哎呀，一起去吧。
ああ，みんな私のせいだ．	唉，都怪我。
ああ，すべておしまいだ．	嗐，一切都完了。
よい！ああ，本当によい！	嫽！咳，真嫽！
ああ，わかりました．	哦，我知道了。
ああなんということだ！	我的天！
おやおや，ああびっくりした，ああ困った！	我的妈呀！((慣用語))
まあ焦るな！	你先别着急！
私は英語が上手ではありません！ふう！なんと言えばいいかわからない……わああああ！	我不怎么会英语！哎！不知道该说些什么……啊啊啊啊啊！
ああ悲しいかな，（現在では人の死をおどけて言う場合の）ああくたばりやがったよ，ああおだぶつになったよ！	呜呼哀哉！
ああ、早く君を抱きしめたい。	啊，想早点拥抱你。
まあ、あとは私次第ということだ。	哎呀，之后就看我的了。
ああ、それは最高だった。	啊！那真是太棒了！
ああ、君か。びっくりしたよ。	啊啊，是你啊。吓我一跳。
彼は笑って「ああ」と言った．	他笑着“啊”了一声。
ああ！なんと美しい景色だろう！	啊！景色多么美！
ああ！そうだったんですか！	啊！是这么回事啊！
ああ，私はとんでもないばかだった！	唉，我真傻！
ああ大変だ，家が家事だ！	哎呀，可不得了，房子着火了！
ああ，本を持って来るのを忘れた！	咳，我忘了带书！
ああ！太陽が出た（出ている）！	啊！太阳出来啦！
こう行くの，それともああ行くの？	这么走还是那么走？
ああ，これはなんということだ！	恶，是何言也！
ああ，なんと悲しむべきことか！	吁，可悲也！
こうしてもよいし，ああしてもよい．	这么行，那么也行。
「あああ…」と彼は口では返事をしたが，気持ちはよそへ行っていた．	“噢噢噢…”他嘴里应诺着，却心不在焉。
マニキュア油．	指甲油
ああ！青二才め，一緒に謀る値打ちもない．	唉！竖子不足与谋。
何かアイデアある？	有什么点子吗？
ハアハア荒い息をする．	喘粗气
アジアアフリカ諸国．	亚非国家
ああ、これが私たちがしなくちゃならないことだ。	啊啊，这是我们必须要做的事情。
ああ、やんなっちゃう。不平屋がきた。	啊，好烦啊。发牢骚的人来了。
ああ、それはあのような感じですか。	啊，那个是像那样的感觉么。
ああ、それとお帰り、しばらくだね。	欢迎回来，有段时间没见了吧。
彼は帰って来たか？—ああ，帰って来たよ．	他回来了吗？—啊，回来了。
ああ，黄河よ！お前は中華民族の揺りかごだ．	啊，黄河！你是中华民族的摇篮。
彼は「ああ」と一声言ったまま行ってしまった．	他只唉的一声就走啦。
ああ，私の間違いだ，ぜひとも改めなくちゃ．	嗳，我错了，一定改。
ああなんということだ！	我的天！
まあ、あとは私次第ということだ。	哎呀，之后就看我的了。
ああ，これはなんということだ！	恶，是何言也！
こういうのはよくない，ああいうのがよい．	这样不好，那样才好。
こういうのはよくない，ああいうのがよい．	这样不好，那样才好。
ああいう心にもないあいさつは大嫌いである．	我最讨厌那种言不由衷的寒暄。
あなたはああいうやつら並みの考えでは絶対だめだ．	你千万不要跟那伙儿人一般见识。
彼のああいう話はもう聞き飽きた．	他那些话我都听腻了。
ああいう耳障りな言葉は，君は全く構う必要はないよ．	那些不中听的言词，你根本不要去理它。
まあ、あなたの言うことを信用した私も馬鹿だったんだけどね。	算了，相信你的话的我也是个笨蛋。
驚いていたけれど、ああいうことはそんなに珍しいことじゃないんですよ。	虽然你很惊讶，但是那种事并不是那么稀奇哦。
あの人ったらああいうたちで，ちょっと機嫌が悪くなると，仏頂面をする．	他就是那么个脾性，一不高兴，就挂着个脸。
ピコFLOという用語は、FLO物理レイヤとメディアアクセス制御（MAC）レイヤとを使用する短距離ブロードキャスト、マルチキャストまたはユニキャストを指す。	术语“picoFLO”指代使用 FLO物理层和媒体接入控制 (MAC)层的短距离广播、多播或单播。
本発明の発明者は、視聴者のテレビスクリーン上に、特定のメディアコンテンツまたはメディアコンテンツのソースを宣伝するグラフィックおよび／またはテキストを表示する小さいウィンドウを設ける、視聴者向けソフトウェアアプリケーション、すなわち、「ウィジェット」を提供する従来のアプローチは、実質的に不完全であるということを理解している。	本发明的发明人认识到，提供在消费者的电视屏幕上产生显示宣传特定媒体内容或媒体内容源的图形和 /或文字的小视窗的消费者软件应用，即，“窗口小部件”的常规方法实质上是有缺陷的。
また、報知開発プログラム28は、「仮想センサ」からの入力を受信できるが、「仮想センサ」とは、電子機器10で動作する他のソフトウェアアプリケーション又はプログラムからの特性、設定、情報等を判定するよう構成した論理モジュールのことを言う。	通知开发程序 28还可以从“虚拟传感器”接收输入，“虚拟传感器”是指被配置用于从电子装置 10上运行的其他应用软件或程序来确定特征、设置、信息等的逻辑模块。
当業者は更に、本明細書で開示された実施形態に関連付けて説明された様々な例示的な論理ブロック、モジュール、回路、およびアルゴリズム・ステップは、電子ハードウェア、コンピュータ・ソフトウェア、あるいはこれら両方の組み合わせによって実現されうるということを正しく理解するだろう。	技术人员将进一步了解，结合本文中所揭示的实施例而描述的各种说明性逻辑块、配置、模块、电路及算法步骤可实施为电子硬件、计算机软件或两者的组合。
当業者等は更に、本明細書中で開示される諸実例と関連して説明された、種々の例示的な論理ブロック、モジュール、回路、方法、およびアルゴリズムは、エレクトロニック・ハードウェア、コンピュータ・ソフトウェア、或は両者の組合せとして、実装されることが可能であるということ、を認識する。	本领域的技术人员还将认识到，在本文中结合本公开的实例来描述的示例性逻辑块、模块、电路、方法和算法可实现为电子硬件、计算机软件或两者的组合。
ああ悲しいかな，（現在では人の死をおどけて言う場合の）ああくたばりやがったよ，ああおだぶつになったよ！	呜呼哀哉！
まあ、あなたの言うことを信用した私も馬鹿だったんだけどね。	算了，相信你的话的我也是个笨蛋。
また、報知開発プログラム28は、「仮想センサ」からの入力を受信できるが、「仮想センサ」とは、電子機器10で動作する他のソフトウェアアプリケーション又はプログラムからの特性、設定、情報等を判定するよう構成した論理モジュールのことを言う。	通知开发程序 28还可以从“虚拟传感器”接收输入，“虚拟传感器”是指被配置用于从电子装置 10上运行的其他应用软件或程序来确定特征、设置、信息等的逻辑模块。
彼は笑って「ああ」と言った．	他笑着“啊”了一声。
ああ！うまくいった！私は（科挙の試験に）合格した．	噫！好了！我中了。
彼は「ああ」と一声言ったまま行ってしまった．	他只唉的一声就走啦。
彼ときたらこう言ってみたり，かと思えばああ言ってみたり．	他一会儿这么说，一会儿那么说。
彼は「ああ，長城は誠に雄大だ！」と賛嘆して言った．	他赞叹地说：“啊，长城真雄伟！”
彼はあそこの風景がこうもよいああもよいと言った．	他说那地方风景怎样怎样好。
彼はため息をついたり舌打ちしたりして言った，「ああ！チッチッ！君は私の苦しい立場がわからないのだ」	他又叹气又咂嘴：“唉！啧！你不知道我的难场。”
ゲートウェイ・デバイス40はさらに、OSPF、RIP、ISIS、IGRP、EIGRPまたはBGPルーティング機能などといった、既知のルータまたはルーティング機能47（ハードウェアまたはソフトウェアあるいはその両方に具現化される）を含む。	网关设备40还包括已知路由器或路由功能47(用硬件和 /或软件具体化 )，诸如 OSPF、RIP、ISIS、IGRP、EIGRP或 BGP路由功能。
ゲートウェイ・デバイス240はさらに、OSPF、RIP、ISIS、IGRP、EIGRPまたはBGPルーティング機能などといった、既知のルータまたはルーティング機能247（ハードウェアまたはソフトウェアあるいはその両方に具現化される）を含む。	 网关设备 240还包括已知路由器或路由功能 247(用硬件和 /或软件具体化 )，诸如OSPF、RIP、ISIS、IGRP、EIGRP或 BGP路由功能。
通信チャネル15は、一般に、ソースデバイス12から宛先デバイス16へビデオデータを送信するための任意の適切な通信メディアあるいは異なる通信メディアの寄せ集めを表す。	通信信道 15通常表示用于将视频数据从源装置 12发射到目的装置 16的任何合适的通信媒体或不同通信媒体的集合。
例えば、そのソフトウェアが同軸ケーブル、光ファイバケーブル、ツイストペア、デジタル加入者回線（DSL）、或いは赤外線、無線、及びマイクロ波といった無線技術を使用してウェブサイト、サーバ、または他の遠隔源から送信されるならば、同軸ケーブル、光ファイバケーブル、ツイストペア、DSL、或いは赤外線、無線、及びマイクロ波といった無線技術は、媒体の定義に含まれる。	例如，如果软件是使用同轴电缆、光纤电缆、双绞线、数字订户线 (DSL)、或诸如红外、无线电、以及微波之类的无线技术从 web网站、服务器、或其它远程源传送而来，则该同轴电缆、光纤电缆、双绞线、DSL、或诸如红外、无线电、以及微波之类的无线技术就被包括在介质的定义之中。
上述したように、1つの実施形態では、アドレス解決プロトコル（ARP）を使用して接続性フェイルオーバを実施し、第1のクラスタのメディアアクセス制御（MAC）アドレスが、スイッチ114などの隣接するネットワークノードにおいて第2のクラスタのMACアドレスに置き換えられることを、隣接するネットワークノードに通知することができる。	如上所述，连通性故障转移在一个实施例中可以如下方式来实现： 使用地址解析协议 (ARP)向诸如交换机 114之类的相邻网络节点通知第一集群的介质访问控制 (MAC)地址在这些相邻网络节点中将用第二集群的 MAC地址替换。
彼は笑って「ああ」と言った．	他笑着“啊”了一声。
彼ときたらこう言ってみたり，かと思えばああ言ってみたり．	他一会儿这么说，一会儿那么说。
彼は「ああ」と一声言ったまま行ってしまった．	他只唉的一声就走啦。
彼は「ああ，長城は誠に雄大だ！」と賛嘆して言った．	他赞叹地说：“啊，长城真雄伟！”
彼はあそこの風景がこうもよいああもよいと言った．	他说那地方风景怎样怎样好。
彼はため息をついたり舌打ちしたりして言った，「ああ！チッチッ！君は私の苦しい立場がわからないのだ」	他又叹气又咂嘴：“唉！啧！你不知道我的难场。”
ああ、あなたでしたか。	啊，是你啊。
ああ，わかりました．	噢，我懂了。
ああ！あなたも心の優しい人だ！	啊！你也是个软心肠！
ああ，わかりました．	哦，我知道了。
ああ，みんな私のせいだ．	唉，都怪我。
おやおや，ああびっくりした，ああ困った！	我的妈呀！((慣用語))
ああ悲しいかな，（現在では人の死をおどけて言う場合の）ああくたばりやがったよ，ああおだぶつになったよ！	呜呼哀哉！
ああ、早く君を抱きしめたい。	啊，想早点拥抱你。
ああ、君か。びっくりしたよ。	啊啊，是你啊。吓我一跳。
ああ，私はとんでもないばかだった！	唉，我真傻！
まあ、あとは私次第ということだ。	哎呀，之后就看我的了。
「あああ…」と彼は口では返事をしたが，気持ちはよそへ行っていた．	“噢噢噢…”他嘴里应诺着，却心不在焉。
私は英語が上手ではありません！ふう！なんと言えばいいかわからない……わああああ！	我不怎么会英语！哎！不知道该说些什么……啊啊啊啊啊！
ああ！うまくいった！私は（科挙の試験に）合格した．	噫！好了！我中了。
ああ！（天が私を滅ぼした→）運命に見放された！	噫！天丧予！
彼は「ああ」と一声言ったまま行ってしまった．	他只唉的一声就走啦。
ああ、これが私たちがしなくちゃならないことだ。	啊啊，这是我们必须要做的事情。
彼らは私のことをああだこうだと非難した．	他们对我百般攻击。
こうだと主張したかと思うと，ああだと主張する．	忽而主张这样，忽而主张那样。
彼は「ああ，長城は誠に雄大だ！」と賛嘆して言った．	他赞叹地说：“啊，长城真雄伟！”
ああ，彼は病気でこんなになってしまった！	嗐，他竟病成这个样子！
ああ，君とお会いするのがどうして遅かったのだろうか！	吁，君何见之晚也！
お姉さん，さああなたを占ってあげましょう．	大嫂，来替你占一课。
まあ、あなたの言うことを信用した私も馬鹿だったんだけどね。	算了，相信你的话的我也是个笨蛋。
ああ，私の間違いだ，ぜひとも改めなくちゃ．	嗳，我错了，一定改。
彼のああいう話はもう聞き飽きた．	他那些话我都听腻了。
ああ、そうしたら私はあなたの家を簡単に見つけられる。	啊，那样的话我就能很容易地找到你家了。
彼はため息をついたり舌打ちしたりして言った，「ああ！チッチッ！君は私の苦しい立場がわからないのだ」	他又叹气又咂嘴：“唉！啧！你不知道我的难场。”
一ヵ月半で250点のスコアアップを実現しました。	我实现了一个半月提高250分。
（困惑・怒り・驚きなどの強い感情を示し）ああ困った，これは大変，なんてことだ！	我的老天爷！
私は（ああも思いこうも考えた→）あれこれ考えたけれどもよい方法は考えつかない．	我左思右想也想不出好办法来。
小さい工場が，よくもまああんな精密な計器を作るとは，本当に大したものだ．	一个小厂子，居然造出那么精密的仪器来，真了不起。
驚いていたけれど、ああいうことはそんなに珍しいことじゃないんですよ。	虽然你很惊讶，但是那种事并不是那么稀奇哦。
キャリアアップのために転職する。	为了职业发展转行。
じゃあ明日午後一時に待ってます。	那明天下午一点等你。
キャリアアップのために毎日2時間勉強しています。	为了提高自己的能力和水平，每天学习两小时。
エリアアレイCOMS画像センサ114は本明細書ではフルアレイ、エリアアレイ、またはCMOS画像センサ、またはこれらの組み合わせとも称される。	面阵 CMOS图像传感器 114在这里还称作全阵列、面阵或CMOS图像传感器或它们的组合。
エドガー・シャインはキャリアアンカーを提唱し、それを8つの要素に分類した。	艾德加•施恩倡导职业锚并把其分为8个要素。
私は転職について助言をもらうためにキャリアアドバイザーに予約をとった。	为了寻求换工作的意见，我预约了职业顾问，
図5において、値501はデータリンク層の送信先ハードウェアアドレスを示している。	参考图 5A和 5B，值 501指示数据链接层中的目的地硬件地址。
図7において、値701はデータリンク層の送信先ハードウェアアドレスを示している。	参考图 7A和 7B，值 701指示数据链接层中的目的地硬件地址。
図12において、値1201はデータリンク層の送信先ハードウェアアドレスを示している。	参考图 12A和 12B，值 1201指示数据链接层中的目的地硬件地址。
図14において、値1401はデータリンク層の送信先ハードウェアアドレスを示している。	参考图 14A和 14B，值 1401指示数据链接层中的目的地硬件地址。
この商品の売上に対するクーポン配布の効果を測定するためにビフォアアフター分析を実施した。	为了测定这个商品通过分发优惠券能对销售总额产生什么样的影响，我们进行了事前事后分析。
RDSデータ監視アプリケーションレイヤ307も、ソフトウェアアーキテクチャ中に含まれていてもよい。	所述软件架构中还可包含 RDS数据监视应用程序层 307。
メディアアダプタ84は、メディアストリーム要求をストリーミングサーバ76に対して開始し（ステップ430）、ストリーミングサーバ76は、コンテンツ項目のメディアストリームをメディアアダプタ84に返信する（ステップ432）。	媒体适配器 84启动到流传送服务器 76的媒体流请求 (步骤 430)，流传送服务器 76将内容项的媒体流返回到媒体适配器 84(步骤 432)。
ユーザデバイス70は、メディアストリーム要求を、メディアアダプタ84により開始する（ステップ428）。	用户装置 70启动与媒体适配器 84的媒体流请求 (步骤428)。
【図10】実施形態によるモバイルデバイスのソフトウェア構成を示したソフトウェアアーキテクチャ図である。	图 10是根据实施例解说移动设备的软件组织的软件架构图。
UE10はさらに、ユーザコマンドに応答して、1つ以上のソフトウェアまたはファームウェアアプリケーションを実行してもよい。	UE 10还可以响应于用户命令来执行一个或多个软件或固件应用程序。
そして、ネットワークI／F−A2010のハードウェアアドレスの値を、SNMP302から問い合わせを受けたMIB（1.3.6.1.2.1.2.2.1.6.1）の値としてSNMP302に返信する。	然后，MIB 301将网络接口 A 2010的硬件地址的值返回到 SNMP 302，作为 SNMP 302询问的 MIB对象 +索引 (1.3.6.1.2.1.2.2.1.6.1)的值。
義理つきあい．	人情应酬
深い谷あい．	幽嶰
つきあい方．	周旋的方法
愛して。	去爱。
あいつのせいだ。	都是寒暄的错。
またあいましょう。	再见面吧。
開会のあいさつ	开幕词
あいまいな態度．	态度暧昧
あいさつの電報．	致敬电
試合の相手方．	比赛的对方
あいにくの天気．	天公不作美
議長あいさつ．	主席致辞
来賓あいさつ．	来宾致辞
つきあいをやめる．	停止周旋
お愛想言葉，（常套の）あいさつ言葉．	应酬话
あいにく満席です。	不凑巧是满座。
誰にあいたいのですか？	你想见谁？
今晩あいてますか。	今晚你有空吗？
あいつを捕まえよう！	逮捕那个家伙吧！
あいつは中二病だ。	那家伙有中二病。
連絡をとりあいましょう。	保持联系。
日曜日にあいましょう。	周天见吧。
あいつは俗物だ。	那家伙是俗人。
あいつ、ぶったたいてやる。	我去揍那家伙。
あなたと愛し合いたい。	我想与你相爱。
あいつは裏切り者だ。	那家伙是背叛者。
今夜あいてますか？	今天晚上有空吗？
あいつとは馬が合う。	和那家伙意气相投。
あいつを逃がすな。	不要让他逃走。
チャックあいてるよ！	拉链开了！
あいつは大ぼら吹きさ。	他是个吹牛大王。
ああ、いっしょに行くよ。	哎呀，一起去吧。
あいつは出来損ないだ。	那家伙是个饭桶。
あいもかわらぬ気性．	老脾气
在庫がわりあい豊富だ．	存货比较丰富。
感謝のあいさつをする．	致感谢词
国際的なつきあい．	国际交往
あいまいではっきりしない．	含混不清
歓迎のあいさつを述べる．	致欢迎词
あいつはばか野郎だ．	他是个浑蛋。
あいまいな言葉を残す．	留下个活话
彼はつきあいがうまい．	他很会交际。
あいつはとてもずるい．	这个家伙很狡猾。
押し合いへし合いする．	摩肩接踵
就任のあいさつをする．	致就职词
あの（その）人，そいつ（あいつ）．	那人
友達づきあいする．	交朋友
押し合いへし合いする．	前拥后挤
ちょっとあいさつをした．	打了一声招呼。
あいつはもうおしまいだ．	那个人完蛋了。
アイルランド．	爱尔兰’
パラグアイ．	巴拉圭
ウルグアイ．	乌拉圭
電気アイロン．	电熨斗
電気アイロン．	电熨斗
アイスクリーム	冰淇淋
アイス買って。	买冰激凌来。
これはアイスです。	这是冰。
アイゼンハワー．	艾森豪威尔’
アインシュタイン．	爱因斯坦
アイデアを出す．	出点子
いいアイデアだ！	好主意！
アイスが消えましたか？	冰消失了吗？
アイデアを膨らませる。	使想法丰满。
よくアイスを食べます。	我经常吃冰激凌。
アイスが溶けそうだ。	冰激凌看样子要溶化了。
アイロンがけをする。	烫衣服。
抹茶入りアイス	加了抹茶的冰淇淋
私はアイスが好きです。	我喜欢冰。
何かアイデアある？	有什么点子吗？
ウルグアイの大統領	乌拉圭的总统
アイスホッケーをする．	打冰球
彼はアイデアが多い．	他点子很多。
放射性アイソトープ．	放射性同位素
ウルグアイラウンド．	乌拉圭回合
アイスクリーム3人前．	三客冰激凌
無理なアイデアを出すな．	别乱出主意。
異性化ゴム，アイソラバー．	异构化橡胶
服にアイロンをかける．	用熨斗熨衣服。
服にアイロンをかける．	用熨斗熨衣服。
図6に示すように、アイコン表示領域6200においては、中央列のアイコン（たとえばアイコン6240、アイコン6242、アイコン6244）は、それらの左右のアイコン（たとえばアイコン6240に対するアイコン6230およびアイコン6250、アイコン6242に対するアイコン6232およびアイコン6252、アイコン6244に対するアイコン6234およびアイコン6254）よりも大きく表示される。	如图 6所示，在图标显示区域 6200中，中央列的图标 (例如图标 6240、图标 6242、图标 6244)与它们左右的图标 (例如相对于图标 6240的图标 6230及图标 6250、相对于图标 6242的图标 6232及图标 6252、相对于图标 6244的图标 6234及图标 6254)相比被较大地显示。
図6に示すように、アイコン表示領域6200においては、中央列のアイコン（たとえばアイコン6240、アイコン6242、アイコン6244）は、それらの左右のアイコン（たとえばアイコン6240に対するアイコン6230およびアイコン6250、アイコン6242に対するアイコン6232およびアイコン6252、アイコン6244に対するアイコン6234およびアイコン6254）よりも大きく表示される。	如图 6所示，在图标显示区域 6200中，中央列的图标 (例如图标 6240、图标 6242、图标6244)与它们的左右的图标(例如相对于图标6240的图标6230以及图标6250、相对于图标 6242的图标 6232以及图标 6252、相对于图标 6244的图标 6234以及图标 6254)相比，较大地显示。
図6に示すように、アイコン表示領域6200においては、中央列のアイコン（たとえばアイコン6240、アイコン6242、アイコン6244）は、それらの左右のアイコン（たとえばアイコン6240に対するアイコン6230およびアイコン6250、アイコン6242に対するアイコン6232およびアイコン6252、アイコン6244に対するアイコン6234およびアイコン6254）よりも大きく表示される。	如图 6所示，在图标显示区域 6200中，中央列的图标 (例如图标 6240、图标 6242、图标 6244)与它们左右的图标 (例如相对于图标 6240的图标 6230以及图标 6250、相对于图标 6242的图标 6232以及图标 6252、相对于图标 6244的图标 6234以及图标 6254)相比，被较大地显示。
私には、良いアイデアがあります。	我有个好点子。
何かよいアイデアがありますか。	有什么好的想法吗？
いいアイデアを思いついた。	我想到一个好主意。
アイスをおごってくれた。	你请我吃了冰淇淋。
まだ良いアイデアを持っていない。	我还没有好的主意。
私には好きなアイドルがいます。	我有喜欢的偶像。
壮大なアイディアがすきです。	喜欢宏大的构思。
アイコンタクトは重要である。	眼神交流很重要。
なにかいいアイデアある？	有什么好想法吗？
何かアイデアありますか？	有什么想法吗？
このアイライナーは長もちする。	這個眼線可以維持很久。
捕手とアイコンタクトをとる	和接手进行眼神的交流
彼にアイデアが浮かんだ。	他的脑海里浮现出一个想法。
何かアイデアはありますか？	有什么想法吗？
何かアイデアはございますか？	您有什么想法吗？
再生するイベントアイテム	活动项目再生
是非アイスランドに行きたい。	我非常的想去冰岛。
掛け合い漫才．	对口相声
お見合いが終わった。	相亲结束了。
お互いに話し合います。	我们互相谈话。
あなたと愛し合いたい。	我想与你相爱。
（夫婦が）親しみ合い愛し合う．	相亲相爱
掛け合い漫才．↔单口相声，多口相声．	对口相声
彼らはお互いに話し合いをした。	他们互相谈过了。
彼らは…来の知り合いである。	他们因……而相识。
今日、お見合いに行きます。	我今天去相亲。
私はその人と知り合いではない．	我跟这个人不相识。
私は彼と知り合いでない．	我跟他不相熟。
我々は昔からの知り合いである．	咱们是老相与。
私たちはお互い助け合い、励ましあった。	我们互相帮助，互相鼓励。
私はあなたと以前のように愛し合いたいです。	我想和你像以前一样相亲相爱。
昔はお見合いはよくある出会いの形態だった。	在过去，相亲是常见的相识方式。
皆互いに助け合い，学び合うべきである．	大家应该互相帮助，互相学习。
困った時は助け合い，病んだ時はいたわり合う．	患难相救助，疾病相扶持。
彼らは常に支持し合い尊重し合っている．	他们总是相互支持、相互尊重。
工業と農業は互いに依存し合い，互いに援助し合う．	工业和农业互相依赖，相互支援。
ジョンと太郎はお互い助け合いました。	约翰和太郎互相帮助了。
彼らは永遠にお互いを愛し合い続けるでしょう。	他们会互相永远的爱下去吧。
私たちはお見合い結婚ではありません。	我们不是相亲结婚的。
お互いに水曜日に連絡を取り合いましょう。	我们星期三互相联系吧。
私たちはメールで連絡を取り合います。	我们通过短信互相联系。
ジェーンは上海の映画スターと知り合いだ。	简和上海的电影明星相识。
彼らの冗談の言い合いは洗練されている。	他們互相开玩笑很有經驗。
これからも連絡を取り合いましょう。	我们今后也相互联系吧。
私の前に住んでいた人と知り合いだ。	和在我之前住的人是相识。
彼らはそのマイクを取り合いました。	他们互相争夺那只麦克风。
彼らはそのマイクを奪い合いました。	他们互相抢夺那只话筒。
このワインはとても日本料理に合います。	那种葡萄酒跟日本料理很相配。
彼と夏の行事で知り合いました。	我和他在夏天的活动上相识了。
彼らは永遠にお互いを愛し合い続けるでしょう。	他们会相爱到永远吧。
互いに学び合い，力量を実際に当たって調べる．	相互观摩，检阅力量
互いに励まし合い，共に向上する．	互相勉励，共同提高。
派閥が林立し，互いに排斥し合い，暗闘しいがみ合う．	派系林立，相互倾轧，勾心斗角。
私と彼は古くからの知り合いである．	我和他是老相识。
我々は小さい時から互いに知り合いである．	我同他自幼就相知。
知り合いは多いが，気心の知れた友人は得難い．	相识的人虽多，但是知己难得。
この本を読んで、人との出合いは大切だと思いました。	我读了这本书之后觉得与他人的相遇是很重要的。
私と友人は、旅行へ行くと必ず絵葉書を送り合います。	我和朋友去旅行时一定会互相赠送图片明信片。
売り手と買い手の双方が相場の睨み合いを続けている。	买卖双方都持续等待着行情的成熟。
私はあなたのお兄さん（弟）と一昨年知り合いました。	我和你的哥哥（弟弟）是前年相识的。
私はこの本を読んで、人との出合いは大切だと思いました。	我读了这本书，觉得与人的相遇很珍贵。
これら2人の主権者は互いに憎み合い、長い間戦争をした。	这两个权力者相互憎恨，进行了长时间的争斗。
親戚が私のためにお見合いをセッティングしてくれていた。	亲戚帮我准备了相亲。
彼ら2人はペアを組んで，互いに助け合い，手を携えて前進する．	他俩结成对子，互相帮助，共同前进。
彼は連れ合いが一言二言でも相づちを打ってくれるものと思っていた．	他以为老伴会附和他一句半句的。
彼が行きたくない以上，私も無理強いしすぎるのは具合いが悪い．	他既然不愿去，我也不便过于相强。
この事とあの事とは全く関連しない，かかわり合いがない．	此事跟那事毫不相涉。
相関器が、複数の周波数仮説の各々について受信信号を複数の符号位相と相関させる。	相关器在多个频率假言中的每一个中将收到信号与多个码
相関器が、複数の周波数仮説の各々において受信信号を複数の符号位相に相関させる。	相关器在多个频率假言中的每一个中将收到信号与多个码
例えば、変調スキームは、位相シフトキーイング（PSK）ベースの変調スキーム、例えば、直角位相シフトキーイング（QPSK）オペレーションである。	例如，所述调制机制可以是诸如四
おのおののデータ・ストリームについて多重化されたパイロットおよび符号化されたデータは、データ・ストリームのために選択された特定の変調スキーム（例えば、バイナリ・フェーズ・シフト・キーイング（BPSK）、直交フェーズ・シフト・キーイング（QPSK）、Mフェーズ・シフト・キーイング（M−PSK）、M直交振幅変調（M−QAM）等）に基づいて変調（例えば、シンボル・マップ）され、変調シンボルが提供される。	根据为每个数据流选择的特定调制方案 (例如，二进制相移键控(BPSK)，四
これにより、信号処理装置での補間処理によって生成される画像の画質が、放射線検出用の画素20Bが連続して配置された場合と比較して良好となる。	通过这样做，与放射线检测像素 20B互
おのおののデータ・ストリームについて多重化されたパイロットおよび符号化されたデータは、データ・ストリームのために選択された特定の変調スキーム（例えば、バイナリ・フェーズ・シフト・キーイング（BPSK）、直交フェーズ・シフト・キーイング（QPSK）、Mフェーズ・シフト・キーイング（M−PSK）、M直交振幅変調（M−QAM）等）に基づいて変調（例えば、シンボル・マップ）され、変調シンボルが提供される。	可以根据针对每个数据流所选的特定调制方案 (例如，二
図10で説明したように、送信装置100から送信されたデータは、フレームペア間でスワップされているため、第1フレーム（1st Frame）の中に、60Hzの周波数で隣接するインターレースのフレームにした場合のデータが集約されている。	如图 10所示，针对由发送装置 100发送的数据，在组成帧对的帧之间交换数据。 这样，在由发送装置 100发送的第一帧数据中，包括当隔行扫描帧以 60Hz的频率互
おのおののデータ・ストリームについて多重化されたパイロットおよび符合化されたデータは、データ・ストリームのために選択された特定の変調スキーム（例えば、バイナリ・フェーズ・シフト・キーイング（BPSK）、直交フェーズ・シフト・キーイング（QPSK）、Mフェーズ・シフト・キーイング（M−PSK）、M直交振幅変調（M−QAM）等）に基づいて変調（例えば、シンボル・マップ）され、変調シンボルが提供される。	每一数据流的已复用的导频和经编码数据随后基于为该数据流选择的特定调制方案(例如二进制相移键控 (BPSK)、正交相移键控 (QPSK)、M
おのおののデータ・ストリームの多重化された、パイロットおよび符号化データは、そのデータ・ストリームのために選択された特定の変調スキーム（例えば、バイナリ・フェーズ・シフト・キーイング（BPSK）、直角位相子シフト・キーイング（QPSK）、Mフェーズ・シフト・キーイング（M−PSK）、M直角振幅変調（M−QAM）等）に基づいて変調（例えば、シンボル・マップ）されうる。	可以根据为每一个数据流所选定的特定调制方案(例如，二进制相移键控 (BPSK)、正交相移键控 (QPSK)、M
私の愛しい人	我爱的人
愛しい天使達	可爱的天使们
あなたには、愛しい人がいますか？	你有爱的人吗？
私の腕の中にいる愛しい人を思い出す。	在我怀中的可爱的人
あなたの後ろ姿が、最高に愛しい。	你的背影最可爱。
あなたに愛しい人が現れることを願っています。	我希望你爱的人会出现。
あなたに愛しい人が現れることを祈っています。	我祈祷你爱的人会出现。
他の男性とあまり意見が合わなかった。	我和其他男性意见不怎么相合。
位相合せ部4は、書込み部3から受け取った入力タイミングによって求めた、書込み部3が左画像メモリ5Lに左画像を書き込む左画像書込みアドレスを左画像メモリ5Lに出力する。	相位匹配单元 4输出写入地址到左图像存储器 5L，该写入地址已经在从写入单元3接收输入定时时获得并在写入单元 3将左图像写入左图像存储器 5L时使用。
合わせて、位相合せ部4は、読出し部7が左画像メモリ5Lから左画像を読出し、右画像メモリから右画像を読出すために用いる読出し開始アドレスと、後述する等価タイミングを位相調整部6に出力する。	此外，相位匹配单元 4将读取开始地址和相等定时输出到相位调整单元 6，该读取开始地址用于使得读取单元 7从左图像存储器 5L读取左图像并且从右图像存储器 5R读取右图像，这将稍后描述。
命を懸けて争う．	以死相争
注入機，キャストアイアン．	浇铸机
アイアンマンはコミックに登場するヒーローである。	钢铁侠是漫画里的英雄。
結果として、これらのアルゴリズムは、受信信号の同相成分および直交位相成分を別々の「空間的」次元またはブランチ（branch）として扱い、そして受信信号上でより一般的な2次元の「空間的」演算を適用する受信機とは、相容れない。	结果，这些算法与将接收信号的同相和正交分量视为分开的“空间”维度或分支并在接收信号上应用更常见的二维“空间”运算的接收器不兼容。
深い藍色．	海蓝色
深い藍色．	蓝靛色
暖かい色合い．	暖色调
そのクモの体は赤と黄色の間の色だった。	那只蜘蛛的身体的颜色是红色和黄色之间的颜色。
御用組合．	黄色工会
色合いが鮮やかだ．	色泽鲜明
濃い藍色の布．	老蓝布
図25（b）には、「2色文字」のチェックボックスが選択されている状態を示し、「2色文字」が選択された場合、操作パネル12は、更に、黒色のほかにもう1色（代表色）を、赤色，緑色，青色，水色，赤紫色，黄色の6色のうちから選択できる構成となる。	在图 25B中表示选择了“双色文字”的复选框的状态，在选择了“双色文字”情况下，操作面板 12进一步构成为，在黑色以外，能够从红色、绿色、蓝色、淡蓝色、紫红色、黄色这六种颜色中再选择一种颜色 (代表色 )。
味がうまく色合いが美しい．	味甘色美
この布の色合いはきれいだ．	这布的花色很好看。
このため、色成分の割合は、黒色が5／25＝20％、白色が20／25＝80％、となる。	因此，颜色成分的比例中黑色的比例为 5/25＝ 20％，白色的比例为 20/25＝ 80％。
同図では、白色の割合が最も大きいため、白色が代表的な色として決定される。	在该图中，由于白色的比例最大，所以将白色决定为代表性的颜色。
従って、占有割合が最も大きい色成分を代表的な色とする場合では、白色が代表的な色として決定される。	因此，在将占有比例最大的颜色成分作为代表性的颜色的情况下，将白色决定为代表性的颜色。
御用労働組合．	黄色工会
また、色画素を判定する処理としては、例えば、ユーザが選択した代表色（赤色、緑色、青色、水色、赤紫色、黄色の何れか1つ）のRGB値をそれぞれRt，Gt，Btとした場合に、代表色に対して、｜R−Rt｜，｜G−Gt｜，｜B−Bt｜がそれぞれ所定閾値（TH2）以下である場合に、各画素が代表色の色画素であると判定する処理を用いることができる。	此外，作为判定彩色像素的处理，例如能够使用如下处理，即，在令用户所选择的代表色 (红色、绿色、蓝色、淡蓝色、紫红色、黄色中的任一种 )的 RGB值分别为 Rt、Gt、Bt的情况下，对于代表色，在 |R-Rt|、|G-Gt|、|B-Bt|分别为规定阈值 (TH2)以下的情况下，判定为各像素是代表色的彩色像素。
色合いは実物と多少異なる場合がございます。	颜色可能与实物有出入。
1Dの色の差分の場合において、その差分は、標準的な演算上の差分、又は、所与の色空間におけるマッチする支配色の色座標間の割合として計算され得る。	在 1D色差的情况下，所述差可以计算为给定颜色空间中匹配主色的色坐标之间的标准算术差或给定颜色空间中匹配主色的色坐标之间的比率。
このような設定の場合、原稿画像260および付加画像270をそれぞれ色処理して合成し印刷すると、（黒色＋黄色）＋（マゼンタ色）の3色の印刷となり、2色印刷の選択が無駄になる。	接着，当对原稿图像 260和附加图像 270进行颜色处理并将处理后的图像进行叠加并打印时，获得三色图像 ((黑色+黄色 )+品红色 )，致使双色打印的选择成为无用。
特色名が登録済みでない場合には、当該特色名に相当する特色を測色器により測定した測色データに基づいて予め定めた色空間の値を色変換情報として色変換情報保持装置102aに登録する（S103）。	 如果未记录专色名称，则颜色转换信息控制部分 28基于通过比色计测量专色而获得的比色数据，将预定颜色空间中的值记录在颜色转换信息存储装置 102a中作为颜色转换信息 (S103)。
色画素を判定する処理としては、前述したように、ユーザが選択した代表色（赤色、緑色、青色、水色、赤紫色、黄色の何れか1つ）のRGB値をRt，Gt，Btとした場合に、｜R−Rt｜，｜G−Gt｜，｜B−Bt｜がそれぞれTH2以下であるかを判定する処理を行なう。	作为判定彩色像素的处理，如上述那样，在令用户选出的代表色 (红色、绿色、蓝色、淡蓝色、紫红色、黄色中的任一种 )的 RGB值为 Rt、Gt、Bt的情况下，进行对 |R-Rt|、|G-Gt|、|B-Bt|是否分别为 TH2以下进行判定的处理。
これとは異なり、付加画像の色にシアン、2色印刷の色にB＋Bkが選択された場合、付加画像の色シアンは、印刷色（B＋Bk）に含まれないので、本実施例では付加画像は黒に変更される。	然而，当针对附加图像选择了青色而针对双色打印选择了 B+Bk时，在打印颜色组 (B+Bk)中不包含青色，在本实施例中，将附加图像的颜色改变为黑色。
周囲の色が青色である場合、すなわち、代表的な色が青色である場合、表示される画像を水彩画風に変換することにより、周囲の色にマッチした画像を表示することができる。	在周围的颜色为蓝色的情况下，即在代表性的颜色为蓝色的情况下，通过将要显示的图像变换为水彩画风，能够显示与周围的颜色匹配的图像。
最大温黒調は、色調設定値が（255，255，0）の場合に実現される。	当设置了 (255，255，0)的色调设置值时，实现最大暖色调。
上述した処理により、例えば、黒文字用の画素（黒画素）に対する閾値をTH3＝100とし、色文字用の画素（色画素）に対する閾値をTH4＝500とし、色数に対する閾値をTH5＝2とした場合に、黒画素数が5000画素、色画素値が1000画素、色数が2色であれば、黒画素数がTH3以上であり、色画素数がTH4以上であり、色数がTH5以下であるので、処理部は、黒文字画素（黒画素）及び色文字画素（色画素）が共に多く、色数が少ないと判定し、2色文字モードを選択する。	通过上述处理，例如在令对于黑色文字用像素 (黑色像素 )的阈值为 TH3＝ 100、令对于彩色文字用像素 (彩色像素 )的阈值为 TH4＝ 500、令对于颜色数的阈值为 TH5＝2的情况下，如果黑色像素数为 5000像素、彩色像素值为 1000像素、颜色数为 2种颜色，则黑色像素数为 TH3以上、彩色像素数为 TH4以上、颜色数为 TH5以下，因此，处理部判定为黑色文字像素 (黑色像素 )和彩色文字像素 (彩色像素 )都多、而颜色数少，选择双色文字模式。
逆に言うと、付加画像の色として選択された色がシアン、マゼンタおよび黒のいずれかである場合、2色印刷に選択された色がB＋Bkであれば、実際に印刷に使用される色はC、MおよびBkなので付加画像に選択された色が変更されることはない。	即当青色、品红色或黑色中的任意一种被选择为附加图像的颜色、并且针对双色打印选择 B+BK颜色组时，实际用于打印的颜色是 C、M以及 Bk，并且不改变针对附加图像选择的颜色。
変換ステップの間に色補正も行われてもよい。	色彩校正也可以在变换步骤期间进行。
色合い爽やかな向日葵の胸元飾り。	清爽色调的向日葵的胸前装饰。
他に類を見ない、傑出した色合いです。	无与伦比的杰出色调。
実物と写真は色が異なる場合がございます。	实物有可能与照片的颜色不同。
彼は顔色が少し青ざめていて，具合が悪そうだ．	他脸色有点发青，是有病的样子。
藍色のボタンを取り付けるのを手伝ってください．	你帮我配一个蓝色的纽扣儿。
5月の空は柔らかい濃い藍色をしている．	五月的天空显出柔和的蔚蓝色。
インダンスレンで藍色に染色した綿布．	士林布
彼は今新しい相棒を物色中だ．	他正在物色一个新搭档呢。
なお、表示可能な色の数が256色である場合、パレット番号は8ビットの値である。	注意，当可显示的色彩的数量是 256时，调色板编号是 8位值。
濃厚な青と優しい青、ピュアーな白色がお客様にとってもお似合いでした。	浓厚的蓝色和柔和的蓝色、纯净的白色非常适合客人。
代表色算出部22は、画像データDが逆光画像である場合には、肌色域A1の彩度範囲がL軸（グレー軸）に接近するように肌色域A1を移動させ、移動後の色域を肌色域A2とする。	在图像数据 D是逆光图像的情况下，代表色计算部 22以肤色域 A1的彩度范围接近 L轴 (灰度轴 )的方式移动肤色域 A1，将移动后的色域作为肤色域 A2。
消色トナーの残量が所定量を超えている場合は（ステップS603；Yes）、消色トナーを使用した印刷を行う。	在脱色调色剂的余量超过规定量的情况下 (步骤 S603；是 )，进行使用了脱色调色剂的印刷。
消色トナーの残量が所定量を超えている場合は（ステップS802；Yes）、消色トナーを使用した印刷を行う。	在脱色调色剂的余量超过规定量的情况下 (步骤 S802；是 )，进行使用了脱色调色剂的印刷。
黒文字だけでなく色文字（黒以外の色の文字）の視認性も向上させたい場合、ユーザは、高精細モードを選択する。	在不仅想提高黑色文字而且想提高彩色文字 (黑色以外的颜色的文字 )的视认性的情况下，用户选择高精细模式。
例えば、原色フィルタのカラーフィルタである場合には、1画素ごとに赤、緑、青の原色のうちいずれか1色のみの色情報しか得られないため、隣り合う画素は異なる色情報を有するように配列が決められている。	例如，在原色滤波器的情况下，由于每像素只能获得原色即红色、绿色和蓝色中的仅一种颜色的颜色信息，因此确定阵列使得相邻的像素具有不同的颜色信息。
更に、黒画素数が5000画素、色画素数が100画素、色数が5色であった場合、黒画素数がTH3以上であるが、色画素数はTH4未満であり、色数はTH5よりも多いので、処理部は、黒文字画素は多いが色文字画素が少ないので、色数には関係なく、黒文字重視モードを選択する。	进一步，在黑色像素数为 5000像素、彩色像素数为 100像素、颜色数为 5种颜色的情况下，黑色像素数为 TH3以上，但彩色像素数不到 TH4，颜色数比 TH5多，因此，处理部因为黑色文字像素多而彩色文字像素少，所以无论颜色数多少均选择黑色文字重视模式。
この例では、「ジョブリスト」のアイコンボタンB1が選択されているので、他のアイコンボタンの表示色が灰色（無変化）であるのに対して、アイコンボタンB1が灰色から水色に変化している。	 在本例子中，由于选择了‘作业列表’的图标按钮 B1，所以相对于其他图标按钮的显示色为灰色 (无变化 )，图标按钮 B1从灰色改变为浅蓝色。
例えば原稿が白色の場合には出力が大きくなり、原稿に文字が記載されている場合には白色と黒色が交互に並ぶため出力は変動し、原稿が黒色の場合には出力は小さくなる。	例如原稿在白色的场合输出变大，原稿记载了文字的场合，白色和黑色交互排列，因此输出变动，原稿为黑色的场合，输出变小。
深い藍色の上着とスボン．	海蓝褂裤
端末装置から消色トナー選択の印刷データを受信した場合には、消色トナーを選択・使用してドキュメントを印刷する（消色トナー単独使用）。	在从终端装置接收到选择了脱色调色剂的印刷数据的情况下，选择 /使用脱色调色剂来印刷文档 (单独使用脱色调色剂 )。
また、本発明においては、黒文字のほかに1色の色文字の視認性を重視するモード（2色文字モード）がユーザによって選択された場合に、上述した黒文字に対する処理を、指定された1色の色文字に対しても行なう。	此外，在本发明中，在用户选择了不仅重视黑色文字的视认性还重视一种颜色的彩色文字的视认性的模式 (双色文字模式 )的情况下，对所指定的一种颜色的彩色文字也进行上述的对于黑色文字的处理。
変換部160は、代表的な色が白色である場合、淡い色を示すパステル調の画風に画像を変換することもでき、また、代表的な色が青色である場合、水彩画風に画像を変換することもでき、また、代表的な色が黒色である場合、水墨画風に画像を変換することもできる。	变换部 160还能够在代表性的颜色为白色的情况下将图像变换为表示淡颜色的粉彩风格的画风，并且还能够在代表性的颜色为蓝色的情况下将图像变换为水彩画风，并且还能够在代表性的颜色为黑色的情况下将图像变换为水墨画风。
現像装置は、感光体ドラム上の潜像をトナー（カラーの場合は各色のトナー）で現像する。	显影装置用色调剂 (如是彩色时则为各色的色调剂 )显影感光鼓上的潜像。
消色可能な印刷剤は、電子写真方式の画像処理装置（複合機）を例に消色トナーとした場合で説明したが、インクジェット方式のプリンタで使用される、特定波長光の照射で消色（無色化）する消色インクなどでもよい。	以电子照相方式的图像处理装置 (复合机 )为例，说明了可脱色的印刷剂为脱色调色剂的情况，但也可以是在喷墨方式的打印机中使用的、通过特定波长光的照射而脱色(无色化 )的脱色墨等。
他の実施形態において本発明の実際の動作を説明するために、コーラメーカのようなドリンクメーカの一対象物が、コーラ愛飲者に対するよりよい使用のためのフィードバック、およびコーラ缶内の検温器による埋込みRFIDタグ識別を配信するものと仮定する。	为了在另一个实施例中说明本发明的实际操作，假定如可乐制造商的饮料制造商的目标是向可乐饮用者传送更好的使用反馈和将具有温度计的 RFID标签识别嵌入可乐罐中。
他の実施形態において本発明の実際の動作を説明するために、コーラメーカのようなドリンクメーカの一対象物が、コーラ愛飲者に対するよりよい使用のためのフィードバック、およびコーラ缶内の検温器による埋込みRFIDタグ識別を配信するものと仮定する。	为了在另一个实施例中说明本发明的实际操作，假定如可乐制造商的饮料制造商的目标是向可乐饮用者传送更好的使用反馈和将具有温度计的 RFID标签识别嵌入可乐罐中。
相づちを打つ．	打帮腔
相手を見て手を打つ．	看人行事
相槌を打つ以外に何か話せますか？	除了应声附和之外别的还能说些什么吗？
口から出任せに相づちを打つ．≒顺口搭音儿．	顺口答音儿((慣用語))
血圧、脈拍、EKG、およびEEGセンサなど患者に関連するセンサデータは、各患者に結合された様々な医療センサから受信できる。	可从耦合到每一患者的多种医疗传感器接收与患者相关联的传感器数据，例如血压、脉搏、EKG和 EEG传感器。
縁あって巡り会う．	随缘遇合
遠く離れた者同士がちょっとした縁で結ばれる，合縁奇縁．≒千里姻嫁使线牵．	千里姻缘一线牵((ことわざ))
遠く離れた者同士がちょっとした縁で結ばれる，合縁奇縁．≒千里姻嫁使线牵．	千里姻缘一线牵((ことわざ))
遠く離れた者同士がちょっとした縁で結ばれる，合縁奇縁．≒千里姻嫁使线牵．	千里姻缘一线牵((ことわざ))
遠く離れた者同士がちょっとした縁で結ばれる，合縁奇縁．≒千里姻嫁使线牵．	千里姻缘一线牵((ことわざ))
彼はあなたの価格相談に応じる。	他会接受你的价格咨询。
ブロック108において、アクセサリ6は通信を受信している電話4に通信して連結され、電話4は呼び出しに応じるように命令される（または通信のタイプに対応する別の機能を実行する）。	在框 108，将配件 6通信地连接至正在接收通信的电话 4，并且指示电话 4应答呼叫 (或者执行与通信类型相对应的另一功能 )。
鍵をなくしたが，すぐには合い鍵が作れない．	钥匙丢了，一时配不上。
3，4度（鍵を合わせた→）合い鍵を作ったがみんななくしてしまった．	配了三四次钥匙都丢了。
合鍵を作る。	制作备用钥匙。
要求側移動局に関するMIP鍵状態828が、所望されるサービスに関する有効な暗号鍵を移動局が有さないことを示す場合、鍵ステータス検査モジュール820は、鍵プロビジョニング・プロセスをトリガすることが可能である。	 如果请求方移动站的MIP密钥状态 828指示移动站不具有用于合意服务的有效密码密钥，则密钥状态核查模块 820可触发密钥预设过程。
残っているステップが無い場合、方法200はステップ212へ進む。	如果没有更多的步骤，方法 200继续到步骤 212。
一致しない、すなわち分岐「No」の場合、方法400はステップ408へ進む。	如果不存在匹配 (选项“否”)，该方法 400继续到步骤 408。
一致する、すなわち分岐「Yes」の場合、方法400はステップ414へ進む。	如果存在一个匹配 (选项“是”)，该方法 400继续到步骤 414。
まだクエリが存在する場合、方法400はステップ404に戻る。	如果存在更多的询问，方法 400返回到步骤 404。
ある状態が検出された場合、方法300は、ステップ308に進む。	如果检测到条件，则方法 300进行至步骤 308。
完全参加が可能でない場合、方法はブロック508に進む。	如果完全参与不可能，那么方法继续进行到方框 508。
部分参加が可能でない場合、方法はブロック510に進む。	如果部分参与不可能，那么方法继续进行到方框 510。
検出された場合、方法400はステップ440へと進むことができる。	如果检测到，则呈现 400可以继续到步骤 440。
当該部分が認識されない、すなわち分岐「No」の場合、方法200はステップ212へ進む。	如果该部分未被辨认出 (选项“否”)，该方法 200继续到步骤 212。
パケットフローがアクティブでない場合、方法400は、方法400が終了するステップ412に進む。	如果分组流不是激活的，方法 400进入到步骤 412，方法 400结束。
ノードが既にサービス参加向けに構成されている場合、方法はブロック504に進む。	如果已经将该节点配置为用于服务参与，那么方法继续进行到方框504。
ノードがサービス参加向けに構成されていない場合、方法はブロック512に進む。	如果没有将该节点配置为用于服务参与，那么方法继续进行到方框 512。
ノードが完全参加向けにすでに構成されている場合、方法はブロック504に進む。	如果已经将该节点配置为用于完全参与，那么方法继续进行到方框 504。
ノードが完全参加向けに構成されていない場合、方法はブロック516に進む。	如果没有将该节点配置为用于完全参与，那么方法继续进行到方框516。
ノードが部分参加向けにすでに構成されている場合、方法はブロック504に進む。	如果已经将该节点配置为用于部分参与，那么方法继续进行到方框 504。
ノードが部分参加向けに構成されていない場合、方法はブロック520に進む。	如果没有将该节点配置为用于部分参与，那么方法继续进行到方框520。
方法48の第1段階では、RFループバック経路11中のスイッチ82は閉じている。	在方法 48的第一阶段中，RF环回路径 11中的开关 82闭合。
新しい通信が検出されないなら、その場合方法はブロック114へ移動する。	如果没有检测到新的通信，则该方法转至框 114。
通信がまだ継続しているなら、その場合方法は、ブロック110へ戻り、繰り返す。	如果通信仍在进行，则该方法回到框 110并且重复。
従来、半導体チップのワイヤボンディング方法として次のような技術が知られている。	常规上，下面的技术是众所周知的半导体芯片的引线接
UEは、伝送のためにUEに割り当てられた1組の副搬送波を決定することができる（ブロック812）。	UE可以确定被分配给该 UE以用于传输的子载波集合 (方框 812)。
eNBは、伝送のためにUEに割り当てられた1組の副搬送波を決定することができる（ブロック1112）。	eNB可以确定被分配给 UE以用于传输的子载波集合 (方框 1112)。
次に、上記平行状態となっている上筐体1に対して閉方向の力を加えることで、上筐体1を下筐体2に対して平行に閉方向にスライド移動させ、当該携帯端末装置を閉状態とする。	随后，通过对处于平行状态的上壳体 1施加闭
ユーザは、この状態では、上筐体1を閉方向にスライド移動させることができないことから、該上筐体1を閉方向に回転操作することとなる。	这种状态下，由于用户不能沿闭
換言すれば、突出部材35がロックブロック30の平面部30bに当接すると、閉方向のスライド操作で加えられた力が、第1のアーム15を閉方向に回転させる力に変換される。	换句话说，如果伸出件 35与闩块 30的平面部分 30b接触，那么由闭
そして、突出部材35がロックブロック30の平面部30bに当接することで、第1のアーム15の閉方向への回転が加速されると共に、閉方向へのスライド操作が可能となっている。	另外，通过允许伸出件 35与闩块 30的平面部分 30b接触，可加速第一臂 15的闭
ユーザは、この状態では、上筐体1を閉方向にスライド移動させることができないことから、該上筐体1を閉方向に回転操作することとなる。	这种状态下，由于用户不能沿闭
まだステップがある場合、方法200はステップ206に戻って多段認証シーケンスの次のステップの認識判定を繰り返す。	如果存在更多的步骤，方法 200返回到步骤 206，并且重复对于该多步骤验证序列的下一步骤的辨认决定。
多段認証シーケンスにこれ以上ウェブページが存在しない場合、方法300はステップ318へ進む。	如果该多步骤验证序列中不存在更多的网页，方法 300进行到步骤 318。
その選択された光路dがすでに故障状態にある場合、方法500は、次の光路dが処理のために選択されるステップ510に戻る。	如果被选的光路 d已经处于故障状态，则方法 500返回到步骤 510，在此下一光路 d被选择用于处理。
D内の別の光路dが選択のために利用可能である場合、方法500は、次の光路dが処理のために選択されるステップ510に進む。	如果 D中还有光路 d可供选择，则所述方法 500继续到步骤 510，在此下一光路 d被选择用于处理。
例えば、構成パラメータが電力を示し、かつリソースが完全参加に使用可能な場合、方法はブロック514に進む。	例如，如果配置参数指示电力和资源可用于完全参与，那么方法继续进行到方框 514。
例えば、構成パラメータが電力を示し、かつリソースが部分参加に使用可能な場合、方法はブロック518に進む。	例如，如果配置参数指示电力和资源可用于部分参与，那么方法继续进行到方框 518。
検出されない場合、方法400はステップ430へと戻り、察知トリガ・イベントについての監視を続行することができる。	如果没有检查到，方法 400可以返回步骤 430并且继续监测感知触发事件。
他方において生物測定信号102が受信されている場合、方法200はイエスノーの矢印にしたがってステップ202に導かれる。	另一方面，如果已经收到生物测量信号 102，则该方法 200沿着“是”箭头前进到步骤 202。
この場合、方法400では、測定された最初の電力レベルの降下が無視され、ブロック402に戻る。	当这种情况出现时，方法 400忽略所测得的第一功率水平下降，并且返回框 402。
通信処理部140は、渡されたデータに対して、エラー訂正符号の付加、パケット化などの処理を行い、さらに電界結合方式に対応して伝送可能なキャリア周波数で変調した送信信号に変換する変調処理を行い、この送信信号をカプラ150に出力する。	通信处理单元 140对传送来的数据进行增加误差校正码和分组化处理，并进而根据电场耦
（2）HOB領域である第3のOB領域63および第4のOB領域64に、第1の遮光画素910、第2の遮光画素920、第3の遮光画素930および第4の遮光画素940の内の2つを組み合わせて配列させる場合	(2)在第三 OB区域 63和第四 OB区域 64中以组
（4）VOB領域である第5のOB領域65および第6のOB領域66に、第1の遮光画素910、第2の遮光画素920、第3の遮光画素930および第4の遮光画素940の内の2つを組み合わせて配列させる場合	(4)在作为 VOB区域的第五 OB区域 65和第六 OB区域 66中以组
（4）VOB領域である第9のOB領域69および第10のOB領域70に、第1の遮光画素910、第2の遮光画素920、第3の遮光画素930および第4の遮光画素940の内の2つを組み合わせて配列させる場合	(4)在作为 VOB区域的第九 OB区域 69和第十 OB区域 70中以组
当該部分が認識される、すなわち分岐「Yes」の場合、方法200はステップ208へ進んで当該部分に対応するフォーム情報を用いて応答を送信する。	如果该部分被辨认出 (选项“是”)，该方法 200继续到步骤 208，在此使用与该部分对应的表格信息传送一个响应。
影響が存在しない場合、方法500は、次の光路dが処理のために選択されるステップ510に戻る（すなわち、この光路に関して何の措置も講じられない）。	如果没有影响，则该方法 500返回到步骤 510，在此下一光路 d被选择用于处理 (即，对该光路不采取行动 )。
混合アプローチでは、M個のDLサブフレームが、最初のN＋（M−1）N／3個のACK／NACKリソースを使うだろうし、残りの2（M−1）N／3個のリソースは未使用のまま残って、PUSCH送信のために使用することができる。	 在混
この発明は、画像処理装置に関し、特に、文字，図形，写真等が混在したデータを圧縮および伸張するのに適した機能を有する画像処理装置に関する。	本发明涉及图像处理装置，尤其涉及具有适于以混
ある状態が検出されない場合、方法300は、ステップ304に戻る（すなわち、管理システムのリソースは、現在の構成に対する変更をトリガするイベントが検出されるまで、現在の構成に従って、管理され続ける）。	如果没有检测到条件，则方法 300返回至步骤 304(即，管理系统的资源继续根据当前配置来管理，直到检测到触发当前配置改变的事件 )。
パケットフローがアクティブである場合、方法400は、サービス品質ポリシーがRAN内でパケットフローに適用され続けるように、ステップ408に戻る。	如果分组流是激活的，方法 400返回步骤408，从而服务质量策略继续应用于 RAN中的分组流。
「はい」の場合、方法は、ステップ2040に進み、そこでは、復号は成功であると宣言される、そして、方法は、順方向リンク送信の早期終了を可能にするためにACKメッセージ生成に進む。	如果是，则该方法转到步骤2040，在步骤 2040，宣告解码成功，该方法进行 ACK消息生成，以便能够提前终止前向链路传输。
チャネルが使用されるべきかを判定する別のチェック812がなされ、もしチャネルが使用されるべきではないと判定された場合、方法800は動作806に進む。	可以发生另一个检查 812，确定是否应该使用信道，如果确定不应该使用信道，则方法 800可以继续至操作 806。
したがって、図10に示す回路では、送信機は14個（2×（2N−3）に対応する。「N」は「2つ向こうの」容量結合方式において容量結合されるべきデータ線の数である）の容量結合回路を含む。	因此，对于图 10中所描绘的电路，发送器包括十四个电容耦合电路 (对应于 2*(2N-3)，其中“N”为在“隔一线”电容耦合系统中应被电容耦合的数据线路的数量 )。
そして、突出部材35がロックブロック30の平面部30bに当接することで、該突出部材35により、第1のアーム15が閉方向に回転するように押圧される。	另外，由于伸出件 35与闩块 30的平面部分 30b接触，因此第一臂 15被伸出件 35挤压，以致沿闭
なお、このMFP300は、レーザー光を感光に利用する、所謂レーザー方式（電子写真方式）の印刷機能を備える。	 另外，该MFP300具有将激光用于感光的所谓的激光方式 (电子照
なお、プリンタ9は、電子写真方式に限定されるものではなく、インクジェット方式あるいは熱転写方式などの印刷方式により画像形成を行うものであっても良い。	另外，打印机 9并不限于电子照
消色可能な印刷剤は、電子写真方式の画像処理装置（複合機）を例に消色トナーとした場合で説明したが、インクジェット方式のプリンタで使用される、特定波長光の照射で消色（無色化）する消色インクなどでもよい。	以电子照
【図6】本発明の第1実施形態に係わるカメラにおいて、カメラを構えた状態と構えていない状態での、姿勢判定部における検出値を示すグラフである。	图 6是示出在本发明的第 1实施方式的照相机中，在摆好照相机的状态及未摆好照相机的状态下的姿势判定部的检测值的曲线图。
ハッシュ値は、実際の装置とは独立に、実際のエントロピー符号化方法とは独立に、各符号化及び復号化装置に関して同じようにビットレベルで正確である。 これは、ハッシュ値がエントロピー符号化前に計算されるためである。	由于在熵编码之前计算散列值，所以该散列值在每个编码设备和解码设备上具有相同的比特精度，而与实际设备无关并且与实际的熵编码方法无关。
【図6】本発明の第1実施形態に係わるカメラにおいて、カメラを構えた状態と構えていない状態での、姿勢判定部における検出値を示すグラフである。	图 6是示出在本发明的第 1实施方式的照相机中，在摆好照相机的状态及未摆好照相机的状态下的姿势判定部的检测值的曲线图。
彼はあいかわらず改めない．	他仍旧没改。
相変わらず格好良い。	你还是那么漂亮。
何年ぶりかで会ったが，君はあいかわらず若々しい．	多年不见，你还那么年轻。
彼はあいかわらず少しも融通性のない口ぶりだ．	他还是没有一点儿活动的口气。
別れて30年，彼はあいかわらず昔のままだ．	一别年，他仍旧是过去的老样子。
答えはあいかわらずやんわりとしていた．	答话仍然是软绵绵的。
彼の気性はあいかわらずあんな風だ．	他的脾气还是那个样儿。
秋に入ったが，あいかわらず熱い．	入秋了，可是天气依旧很热。
君の気性はあいかわらず当時とそっくりそのままだ．	你的脾气还和当年一模一样。
相変わらずお元気ですね。	你还是一样那么精神抖擞呢。
相変わらず英語が好きです。	我还是和以前一样喜欢英语。
相変わらず忙しいです。	我还是一如既往的忙。
相変わらず素敵ですね。	你还是极其漂亮。
彼は相変わらず面白い人だ。	他仍旧是有趣的人。
私の英語は相変わらず下手です。	我英语还是那么差。
相変わらずお綺麗ですね。	依旧是那么漂亮呢。
相変わらずお忙しそうですね。	看上去还是那么忙。
彼は70過ぎだが，あいかわらず元気はつらつ，足取りは軽やかだ．	他年过七十，精神还那么饱满，步子还那么轻快。
家に用事があるけれど，彼はあいかわらず出勤している．	尽管家里有事，可是他仍然坚持上班。
本来から言えば，彼は共通語がしゃべれて当然なのに，あいかわらず広東語ばかりだ．	按理说，他应该会说普通话，可是他还是满口广东话。
ゴビ砂漠は相変わらず果てしなく広々としており，天気は相変わらず焼けつくようであった．	戈壁滩依旧那样苍茫，天气依旧那样炽热。
私は彼にあれこれ言ったが，しかし彼はあいかわらず同じ返事一点張りだ．	我跟他费了半天唾沫，可他还是那一句话。
午前中はあいかわらず農夫であるが，夜中は銃を担いで兵営を攻撃する．	前半晌还是个庄稼汉，黑夜里背枪打营盘。
くっ、相変わらず愛想の欠片もない！	啊，依然一点儿都不可爱！
彼女は相変わらず肌がつやつやしていた。	她的皮肤总是那么光滑。
彼は相変わらず元気が無さそうだった。	他还是和往常一样没有精神。
その車は相変わらずまだ動かない。	那辆车还是没有动。
彼は相変わらず面白い人だった。	他仍旧是有趣的人。
おばあちゃんはあんなに年がいっているので，本来ならば休養すべきであるのに，あいかわらず町内の仕事に精を出している．	奶奶那么大年纪，按理应该休息，可她仍然忙着街道工作。
生産が伸びないのは，あいかわらず工場の指導者が大衆から離脱し，業務の知識がないことに禍根がある．	生产所以搞不上去，病根仍在厂领导脱离群众，不懂业务。
午後に一度お電話したのですが不在でした。相変わらず忙しそうですね。	下午打了一次电话但是你不在。你还是那么忙呢。
彼は60歳に手が届こうとしているのに，相変わらず極めてエネルギッシュだ．	他是奔六十的人了，可是精力仍然很充沛。
図8は、図7のカメラを縦位置（グリップ124が下の状態）に置いた状態であり、ロール方向の検出方法は横位置の場合と変らないが、ピッチ方向の検出方法は横位置と異なる。	图 8示出图 7中的照相机处于纵向方位 (握持部 124朝下 )的状态。 滚转方向上的检测方法与横向方位时的检测方法相同。
相変わらず格好良い。	你还是那么漂亮。
相変わらずお元気ですね。	你还是一样那么精神抖擞呢。
相変わらず英語が好きです。	我还是和以前一样喜欢英语。
相変わらず忙しいです。	我还是一如既往的忙。
相変わらず素敵ですね。	你还是极其漂亮。
彼は相変わらず面白い人だ。	他仍旧是有趣的人。
私の英語は相変わらず下手です。	我英语还是那么差。
相変わらずお綺麗ですね。	依旧是那么漂亮呢。
相変わらずお忙しそうですね。	看上去还是那么忙。
彼女は僕より3つ年下にもかかわらず、とてもしっかりしている。	虽然她比我小三岁，但是相处非常融洽。
ゴビ砂漠は相変わらず果てしなく広々としており，天気は相変わらず焼けつくようであった．	戈壁滩依旧那样苍茫，天气依旧那样炽热。
くっ、相変わらず愛想の欠片もない！	啊，依然一点儿都不可爱！
彼女は相変わらず肌がつやつやしていた。	她的皮肤总是那么光滑。
彼は相変わらず元気が無さそうだった。	他还是和往常一样没有精神。
その車は相変わらずまだ動かない。	那辆车还是没有动。
彼は相変わらず面白い人だった。	他仍旧是有趣的人。
それにもかかわらず、UE14AおよびUE14Bの両方からの制御信号は、それぞれのチャネル条件の差にもかかわらず、適切に受信されなければならない。	然而，不管信道条件中的相应差异如何，来自于 UE 14A和 UE 14B的控制信号必须被正确地接收。
午後に一度お電話したのですが不在でした。相変わらず忙しそうですね。	下午打了一次电话但是你不在。你还是那么忙呢。
彼は60歳に手が届こうとしているのに，相変わらず極めてエネルギッシュだ．	他是奔六十的人了，可是精力仍然很充沛。
1組の複数画像取込みからの画素の合計の数を比較的一定に保つことによって、複数の画像を取り込むにもかかわらず、複数の個別画像を読み出す時間が比較的一定に保たれる。	通过使来自多图像捕获集的像素的总数目保持相对恒定，不管正捕获的多个图像如何，用以读出多个个别图像的时间均保持相对恒定。
ステップS56では、担当ページにフォームが含まれているか否かにかかわらず、担当ページ中のフォームの他のオブジェクトについての中間データが生成される。	在步骤 S56中，生成相应页面中具有不同格式的对象的中间数据，而不取决于相应页面中是否包含格式。
個別のセクタは必ずしも隣接しているわけではないにもかかわらず、ファイル割当テーブルはハードディスク13のセクタをともに効果的にリンクさせて、必要に応じて個別のファイルを形成する。	 文件分配表将硬盘 13的扇区有效地链接在一起以根据需要构成各文件， 尽管各个扇区并不必需是相邻的。
契約にノートーク条項があったにも関わらず、これら二社が合併交渉中であるニュースがリークし、見出しとなった。	这两个公司不顾合约中有禁止交流的条款，仍在在合并过程中互相交涉的新闻泄露出来并成了大标题。
上記Trap処理による情報取得方法では、機器200を管理対象から除外したにもかかわらず、機器管理装置100に対して機器情報が送信されてしまう。	在使用按照相关技术的捕获处理的信息获取方法中，即使在从管理对象排除装置200之后，装置 200的装置信息也将被传送到装置管理设备 100。
その理由は、カメラ31とCCU33との間が遅延時間Tsであるにもかかわらず、遅延管理時刻で映像データを取り扱えるようにするためである。	这是为了使得能够在延迟管理时间对视频数据进行处理，即使在相机 31和 CCU 33之间存在延迟时间 Ts也如此。
本実施形態では、データチャネル18上で送られるCQI報告および他の制御信号は、データチャネル18上で通常提供されるより低い保護にもかかわらず（図1に示すように）、制御チャネル16上で利用可能な誤り保護に相応の誤り保護レベルを有し得る。	在该实施方式中，在数据信道 18上承载的 CQI报告和其它控制信号可具有与控制信道 16上可利用的错误保护相当的错误保护水平，而不管通常在数据信道 18上提供的较低保护 (如图 1所示 )。
図3では、第2のMS306bはフェムトセル308内に位置されているにもかかわらず、隣接するアップリンクチャネル干渉と隣接するダウンリンクチャネル干渉は、たとえ第2のMS306bがフェムトセル308の外に位置されるとしても、生じうる。	尽管在图 3中，第二 MS 306b位于毫微微小区 308内，但即使第二 MS306b位于毫微微小区 308之外，相邻上行链路信道干扰和相邻下行链路信道干扰也可能会发生。
明示的予測モジュール60または暗黙的予測モジュール62のいずれが第2のバージョンを発生するかにかかわらず、それぞれ活動化されたモジュール60、62のうちの一方は、第2のバージョンをR−D分析モジュール64に渡す。	不管显式预测模块 60或隐式预测模块 62中哪一者产生第二版本，模块 60、62中相应经激活的模块均将第二版本传递到 R-D分析模块 64。
図8は、図7のカメラを縦位置（グリップ124が下の状態）に置いた状態であり、ロール方向の検出方法は横位置の場合と変らないが、ピッチ方向の検出方法は横位置と異なる。	图 8示出图 7中的照相机处于纵向方位 (握持部 124朝下 )的状态。 滚转方向上的检测方法与横向方位时的检测方法相同。
プロセッサ23はファイルシステムソフトウェアを用いてハードディスク13へのデータの保存を管理するので、実際にデータがどのようにハードディスク13に保存されるかにかかわらず、データは隣接したデータストリームとして入力されかつ出力されるように見える。	处理器 23使用文件系统软件来管理数据在硬盘 13上的存储，以便与数据实际是如何在硬盘 13上存储的无关，它看起来是作为相邻的数据流输入和输出的。
本出願で使用される場合、「構成要素」、「モジュール」、「システム」などの用語は、ハードウェアであるか、ハードウェアとソフトウェアの組合せであるファームウェアであるか、ソフトウェアであるか、または実行中のソフトウェアであるかにかかわらず、コンピュータ関連エンティティを指すことが意図されている。	如在本申请中所使用的，术语“组件”、“模块”、“系统”等旨在指示计算机相关实体，无论其是硬件、固件、软硬件组合、软件，还是执行中的软件。
図1では、所与のペアのセットトップボックスは、ソース／受信のペアとして動作する。 どのセットトップボックスがペアを構成するかに関わらず、上述されたように、2つの関連する信号が常に存在する。	 与哪些机顶盒组成一对无关，如上所述，总是将存在两个相关的信号。
本発明によって提供されるさらなる利点は、複数の画像が取り込まれるにもかかわらず、形成された合成画像内の画素の数、合計の読出しおよび記憶時間、ならびに合計の露出時間がすべてズーム範囲全体にわたって比較的一定に保たれるような柔軟なズームシステムが、複数の画像取込みから提供されることである。	本发明所提供的另一优点在于，按以下方式从多个图像捕获提供一种灵活变焦系统： 不管所捕获的多个图像如何，所形成的合成图像中的像素数目、总读出及存储时间以及总曝光时间在整个变焦范围内均保持相对恒定。
全てのノードB404a、404bは、RNC406が生成するものと同一のACKまたはNACK信号を、各ノードB404a、404bが独立してデータパケットから導出するCRCの結果に関わらず、WTRU402に対して送信する（ステップ462および466）。	所有节点 -B 404a、404b传送由该 RNC 406决定的相同 ACK或 NACK信号至该 WTRU 402，无论每一个节点 -B 404a、404b分别从数据分组得到的 CRC结果如何 (步骤 462及 466)。
かつ、露光時間が垂直同期期間より、長い、または短いに関わらず、奇数フィールドの読み出し期間に対して、常に2垂直走査期間前に通信すればよいことを示している。	另外，不管曝光时段是比垂直同步时段长还是短，都仅仅要求总是相对于奇数场的读出时段提前两个垂直扫描时段地进行通信，如图中所示出的。
なお、図3では、説明のため水平方向のみスケーリング処理を行っている様子を示しているが、実際にはアスペクト比が変わらないように垂直方向のスケーリング処理も行われる。	注意，虽然图 3为了说明而仅示出如何执行水平方向上的缩放处理，但实际上，也执行在垂直方向上的缩放处理，以保持相似的宽高比。
他の実施形態によれば、信号生成構成要素208は、波形タイプに関わらず、実質的に同じ復調基準信号を生成し、この復調基準信号を、波形タイプに応じて、異なるシンボル・ロケーション、トーン・ロケーション、またはこれらの組み合わせで送信しうる。	根据其它实施例，不管波形类型是哪种，信号生成部件 208都生成基本相似的解调参考信号； 并能够根据波形类型，在不同的符号位置、音调位置或者它们的组合，发送解调参考信号。
ユーザは、対応づけの更新をあらためて実行せずに済む。 また、その際、図3のS24に示すように、警告表示が行われるため、ユーザは、アプリケーションA1が過去に実行される際に、現在対応づけられている証明書（例えば「C2」）を自身が指定したにも関わらず、アプリケーションA1が今回に実行される際に、証明書（例えば「C2」）と異なる新たな証明書（例えば「C4」）を指定したことを知ることができる。	如图 3中所示，当应用程序 A1被执行时，用户可以指定与对应于应用程序 A1的证书 (例如，“C2”)不相同的新证书 (例如，“C4”)。
ここでは、無線通信システム200の稼働状況に応じて、無線通信システム100において使用されるサブキャリアS11のセットを決定する方法を説明したが、無線通信システム100では、無線通信システム200の稼働状況に関わらず、所定の条件、例えば、「各無線基地局のリソース使用率がX％以下となるNとmとのセットを選択する」ことに基づいて、無線通信システム100におけるトラフィックの状況に合わせてNとmとを決定してもよい。	这里，说明了根据无线通信系统 200的工作状况来决定无线通信系统 100中使用的子载波 S11的集合的方法，但是在无线通信系统 100中，可以与无线通信系统 200的工作状况无关地，根据预定条件例如“选择各无线基站的资源使用率在 X％以下的 N和 m的集合”，与无线通信系统 100中的流量状况相结合来决定 N和 m。
図8は、図7のカメラを縦位置（グリップ124が下の状態）に置いた状態であり、ロール方向の検出方法は横位置の場合と変らないが、ピッチ方向の検出方法は横位置と異なる。	图 8示出图 7中的照相机处于纵向方位 (握持部 124朝下 )的状态。 滚转方向上的检测方法与横向方位时的检测方法相同。
相変わらず格好良い。	你还是那么漂亮。
相変わらずお元気ですね。	你还是一样那么精神抖擞呢。
相変わらず英語が好きです。	我还是和以前一样喜欢英语。
相変わらず忙しいです。	我还是一如既往的忙。
相変わらず素敵ですね。	你还是极其漂亮。
彼は相変わらず面白い人だ。	他仍旧是有趣的人。
私の英語は相変わらず下手です。	我英语还是那么差。
相変わらずお綺麗ですね。	依旧是那么漂亮呢。
相変わらずお忙しそうですね。	看上去还是那么忙。
ゴビ砂漠は相変わらず果てしなく広々としており，天気は相変わらず焼けつくようであった．	戈壁滩依旧那样苍茫，天气依旧那样炽热。
くっ、相変わらず愛想の欠片もない！	啊，依然一点儿都不可爱！
彼女は相変わらず肌がつやつやしていた。	她的皮肤总是那么光滑。
彼は相変わらず元気が無さそうだった。	他还是和往常一样没有精神。
その車は相変わらずまだ動かない。	那辆车还是没有动。
彼は相変わらず面白い人だった。	他仍旧是有趣的人。
午後に一度お電話したのですが不在でした。相変わらず忙しそうですね。	下午打了一次电话但是你不在。你还是那么忙呢。
彼は60歳に手が届こうとしているのに，相変わらず極めてエネルギッシュだ．	他是奔六十的人了，可是精力仍然很充沛。
イェーイ！	耶！
イ調．	调
ハイファイ．	高保真度
イシガレイ．	石鲽
メイタガレイ．	木叶鳒
イシガレイ．	石鳒
ファイト！！	加油！
ヤバイ！	糟了！
ファイト！	加油！
ファイト！	加油。
マイク．	播音器
ドイツ．	德意志
イクラ．	咸鲑鱼子
ハイネ．	海涅
ハイドン．	海顿
ハイファ．	海法
Lサイズ．	大号
Mサイズ．	中号
Sサイズ．	小号
カレイ．	鳒鱼
黒ソイ．	黑鲪
カイロ．	开罗
タイヤ．	汽车胎
スイス．	瑞士
タイ語．	泰语
ブルネイ．	文莱
トイレ．	洗手间
ハワイ．	夏威夷
イエナ．	耶拿
イラン．	伊朗
イラク．	伊拉克
インド．	印度
イライラします。	很焦躁。
仮のインボイス	临时的发票
アインシュタイン．	爱因斯坦
ハイ，ハイ，ソレ！	嘚儿嘚儿，驾！
タイムスイッチ．	定时电键
インボイス価格．	发票价格
オイオイと泣く．	放声大哭
タイプライター．	打字机
プレイガイド．	联合售票处
スカイダイビング．	特技跳伞
プラスイオンとマイナスイオン，陽イオンと陰イオン．	正离子和负离子
（対空ミサイル）サイドワインダー．	响尾蛇导弹
ディスプレイのスイッチ	显示器的开关
ライフスタイルの変化	生活方式的变化。
イライラが止まらない。	我焦躁不安。
バイバイ、また後でね。	拜拜，之后见！
赤ちゃんはカワイイ。	小宝宝好可爱。
あーイライラしてきた。	啊，变得焦躁起来了。
いいか？—いいよ！	中不中？—中！
痛い！	好疼！
いいね！	真不错！/赞！
いいえ！	不价！
おいしい．	受吃
はい，はい．	唯，唯。
凄い可愛い。	非常可爱。
急いでいます。	很急。
言いなさい！	你说一说！
急いで！	快点！
来い！	快上来！
いい物は高い。	好东西贵。
いい匂いがする。	味道很好闻。
はい、いいですよ。	好，可以哦。
いいえ、違います。	不，不是。
いいえ違います。	不，不是的。
いいえ、ちがいます。	不，不是。
いいえちがいます。	不是的。
いいと思います。	我觉得很好。
いいんじゃない？	不觉得很好吗？
いいことを思いついた。	想到了好事。
Aでもいいし、Bでもいい。	A也可以，B可也以。
来い。	过来。
わーい！	耶！
いつ．	何时
名医．	名医
幸い災害に至らない．	幸未成灾
狭い．	迮狭
いいですか？	可以吗？
いいですよね？	可以吧？
いいですね。	真好啊。
へぇ、いいな。	哎，真好啊。
書いている。	正在写。
いいもん。	好东西。
なんでもいい。	怎么都好。
汗臭い匂い	汗臭味
いい気味だ。	感觉不错。
会いたいです。	我想见你。
いい空です。	很美的天空。
会いたい人	想见的人
どうでもいい。	随便。
どっちがいい？	哪个好？
家に居たい。	我想在家。
調子がいい	状态很好
仲がいい	关系好。
別にいいです。	没关系。
もういいよ。	已经够了。
いいですよ。	好啊。
美容にいい。	对美容好。
いいですよ。	可以哦。
居合道の練習	练习
事故が発生した時彼が居合わせたし，私も居合わせた．	事故发生时他在场，我也在场。
そこに居合わせたみんながパニックになった。	刚刚正好在那边的群众都恐慌了。
居合わせた人たちは泥棒を押し倒した．	群众把小偷按倒了。
事件が発生した時，折よく私はその場に居合わせた．	事情发生的时候，正巧我在场。
彼は一人々々その場に居合わせた人に尋問した．	他要一个一个地质询在场的人。
彼の無作法なふるまいに居合わせたみんながあきれた。	他粗鲁的举止让所有在场的人惊呆了。
居合わせた二人からの冷やかしに、私と彼女は頬を赤くした。	因为在场两人的嘲笑，我和她都脸红了。
雲南省にあるイ族自治県の名．	宁蒗
新疆ウイグル自治区にある県名．	莎车
現在の雲南省峨山イ族自治県．	嶍峨
昨日、栃木県へハイキングに行ってきました。	昨天去栃木县郊游了。
新疆ウイグル自治区にある県名（現在は‘若羌’）．	婼羌
日本で唯一のクローバー型高速道路インターチェンジは佐賀県にある。	日本唯一的一个四叶草型高速交流道在佐贺县。
また、観光パンフレットが県観光協会のサイトからもダウンロードできますので、こちらも御利用ください。	另外，观光手册也可以从县观光协会的网站下载，这也请进行利用。
彼は話し方が穏やかなだけに、かえって威圧感がある。	正因为他的说话方式很稳重，才更有权威感。
彼はいつも権勢をかさに人を威圧するので，皆彼を憎んでいる．	他老是仗势欺压人，所以大家都恨他。
彼はいつも権勢をかさに人を威圧するので，皆彼を憎んでいる．	他老是仗势欺压人，所以大家都恨他。
双方の場合において、我々は、直交パイロットシーケンスを異なる送信機に割り当てる。	在这两种情形中，我们把正交导引序列指派给不同的发射机。
換言すれば、このように提供されるアフィニティ・アドレスは、サーバ・アプリケーション・プログラムの所与のインスタンス204、205、206に一時的にのみ割り当てることができる。	 换句话说，以此方式提供的仿射地址可仅临时分配到给定服务器应用程序实例 204、205和 206。
図1は多数のテレビ受像機104および112を示しているが、コンテンツソース102からのコンテンツの伝送に関する説明は、テレビ受像機104に対するコンテンツの送達に焦点を当てる。	虽然图 1图解说明多个电视接收器 104和 112，但关于内容从内容源 102的发射的描述将聚焦于内容到电视接收器 104的递送。
一態様においては、リソース割り当てモジュール414は、送信ダイバーシティ方式を用いて送信される制御情報に複数のリソースを割り当てるために動作可能であることができる。	在一个方面中，资源分配模块 414可以操作为将多个资源分配给要使用发射分集方案发送的控制信息。
本発明の一実施形態において、我々は、基本的には直交パイロットシーケンスを送信機に割り当てることにより、DVB−T2 SFNにおける送信機の存在を依然としてウォータマークするが、我々は、OFDM領域におけるDVB−T2信号をもつWMシーケンスを多重する、即ち、時間又は周波数多重することからなる非常に異なるアプローチを用いる。	在本发明的实施例中，我们仍旧通过基本上指派正交导引序列给发射机，而在DVB-T2 SFN中给发射机的存在加水印，但我们使用完全不同的方法，它包含在 OFDM域中复用，即，时间或频率复用 WM序列与 DVB-T2信号。
対照的に、参照数字206において、WCDが送信ダイバーシティ方式を用いて通信することが可能であることが決定された場合は、参照数字212において、同意された送信ダイバーシティ方式を実装することができ、及び、一態様においては、生成された応答を通信するために複数のリソースを割り当てることができる。	相反，如果在参考标号 206处，确定 WCD能够使用发射分集方案进行通信，则在参考标号 212处，可以实现达成一致的发射分集方案，并且在一个方面中，可以分配多个资源用于传送所生成的响应。
リソースの数を制御するために、送信ダイバーシティモジュール（112、122）は、異なる巡回シフトを有する異なるリソース間での最小の時間領域分離を決定する適切な巡回シフトデルタパラメータを割り当てることができる。	为了控制多个资源，发射分集模块 (112、122)可以指派合适的循环移位增量 (delta)参数，该循环移位增量参数可以确定采用不同循环移位的不同资源之间的最小时域间隔。
送信ダイバーシティを実装するために、少なくとも2つの該リソース（又は、例えば、より大きい多アンテナ送信に関してはそれよりも多い）を、システム内においてサービスが提供される各WCDに対して割り当てることができる。	为了实现发射分集，可以将至少两个这样的资源(或者，例如，用于更大的多天线传输的更多个资源)指派给在该系统中服务的每个WCD。
さらに、一態様においては、プロセッサ406は、送信ダイバーシティモジュール412が受信されたコンテンツを処理し、処理されたコンテンツに応答して制御情報を生成し、送信ダイバーシティ方式を用いて制御情報を送信するための2つの又はそれより多い送信アンテナと関連づけられた2つの又はそれより多いリソースを割り当て、割り当てられたリソースへの巡回シフトデルタパラメータを決定し、及び決定された割り当てられたリソースに制御情報を割り当てることを可能にするための手段を提供することができる。	此外，在一个方面中，处理器 406可以提供模块来允许发射分集模块 412处理接收的内容、响应于所处理的内容生成控制信息、分配与两个或更多个发射天线相关联的两个或更多个资源用于使用发射分集方案发送控制信息、针对所分配的资源确定循环移位增量参数以及将控制信息指派给所确定的分配的资源。
6. 前記無線手術室通信システムは、システム同期の間に、複数の周波数チャネルの特性を測定、評価し、最高評価の周波数チャネルを前記異なるチャネルとして、その上でカメラビデオ信号を送信するために前記無線ビデオ送信装置に割り当て、別の周波数チャネルを、その上で事前に記録されたビデオ信号を送信するために前記無線記憶ビデオ送信装置に割り当てることを特徴とする請求項5に記載の無線手術室通信システム。	6. 根据权利要求 5所述的无线手术室通信系统，其中在系统同步期间，所述无线手术室通信系统确定和评价多个频率信道的特性，并且向所述无线视频发射器单元指派最高评价频率信道作为不同的信道，以便在其上传输摄像机视频信号，并且向所述无线存储视频发射单元指派另一频率信道，以便在其上传输预记录的视频信号。
参照数字206において、WCDが送信ダイバーシティ方式を用いて通信することが可能でないことが決定された場合は、参照数字208において、制御情報の通信のために単一のリソースを割り当てることができ、参照数字210において、単一のリソース応答を送信することができる。	如果在参考标号 206处，确定 WCD不能使用发射分集方案进行通信，则在参考标号 208处，可以分配单一的资源用于控制信息通信，并且在参考标号 210处，可以发送该单一的资源响应。
このプログラムは、コンピュータが、入力アダプタを介して含まれる特定の入力信号を運ぶビットストリームを受信するとき、コンピュータが適切なバッファにメモリを割り当てるとともに他の適切な資源を利用し、図4および5に関連して記載した様々な動作を実行するように機能して、特定の出力信号を運ぶビットストリームを出力アダプタを介して送信する命令から構成されている。	程序由指令组成，使得当计算机通过输入适配器来接收传送涉及的特定输入信号的比特流时，计算机对适当的缓冲器分配存储器，并且利用其它适当的资源和功能来执行以上参考图 4和图 5描述的各种操作，并且通过输出适配器来发射传送特定输出信号的比特流。
反対に、ACK SNフィールドが、このレポートに示される最初の見失われたPDUよりも大きいシーケンス番号を含む場合、これは、アクセス端末202が完全ステータス・レポートを送信したか、そうでない場合には、すべての部分的ステータス・レポートの送信を完了したことを示し、結果として、基地局202は、この目的のために、（許可構成要素214によって）さらなるUL許可を提供する必要も、割り当てる必要もないことを示しうる。	 相反，如果 ACK_SN字段含有大于所述报告中指示的第一遗漏 PDU的序号，那么此可提供接入终端 202已发送完整状态报告或替代地已完成所有部分状态报告的发射的指示，且因此基站 202(经由准予组件 214)无需为此目的供应或分配其它 UL准予。
トランスポートストリーム・マルチプレクサによって出力されるSPTSは、最初に他のトランスポートストリームと結合してMPTSを生成することなく、トランスポートストリーム・デマルチプレクサに直接送信される場合もあるが、しかしいずれの場合においても、トランスポートストリーム・デマルチプレクサは、選択されたSPTSのトランスポートストリーム・パケットを受信して、それらをPIDに基づき分離し、トランスポートストリーム・パケットを分解（depacketize）してPESパケットを再生成し、いわゆるビデオ・システムターゲットデコーダ（T−STD）34にビデオPESを宛て、オーディオT−STD38にオーディオPESを宛てることが当業者には認められる。	本领域技术人员将意识到，可以将由传输流复用器输出的 SPTS直接发射到传输流解复用器，而无需首先与其它传输流进行组合来创建 MPTS，但是在任何一种情况下，传输流解复用器接收选定的 SPTS的传输流分组，并且基于 PID对它们进行分离，对传输流分组进行解分组以重建 PES分组，并且将视频PES指向所谓的视频系统目标解码器 (T-STD)34，并且将音频 PES指向音频 T-STD38。
双方の場合において、我々は、直交パイロットシーケンスを異なる送信機に割り当てる。	在这两种情形中，我们把正交导引序列指派给不同的发射机。
本発明の一実施形態において、我々は、基本的には直交パイロットシーケンスを送信機に割り当てることにより、DVB−T2 SFNにおける送信機の存在を依然としてウォータマークするが、我々は、OFDM領域におけるDVB−T2信号をもつWMシーケンスを多重する、即ち、時間又は周波数多重することからなる非常に異なるアプローチを用いる。	在本发明的实施例中，我们仍旧通过基本上指派正交导引序列给发射机，而在DVB-T2 SFN中给发射机的存在加水印，但我们使用完全不同的方法，它包含在 OFDM域中复用，即，时间或频率复用 WM序列与 DVB-T2信号。
一態様においては、リソース割り当てモジュール414は、送信ダイバーシティ方式を用いて送信される制御情報に複数のリソースを割り当てるために動作可能であることができる。	在一个方面中，资源分配模块 414可以操作为将多个资源分配给要使用发射分集方案发送的控制信息。
対照的に、参照数字206において、WCDが送信ダイバーシティ方式を用いて通信することが可能であることが決定された場合は、参照数字212において、同意された送信ダイバーシティ方式を実装することができ、及び、一態様においては、生成された応答を通信するために複数のリソースを割り当てることができる。	相反，如果在参考标号 206处，确定 WCD能够使用发射分集方案进行通信，则在参考标号 212处，可以实现达成一致的发射分集方案，并且在一个方面中，可以分配多个资源用于传送所生成的响应。
送信ダイバーシティを実装するために、少なくとも2つの該リソース（又は、例えば、より大きい多アンテナ送信に関してはそれよりも多い）を、システム内においてサービスが提供される各WCDに対して割り当てることができる。	为了实现发射分集，可以将至少两个这样的资源(或者，例如，用于更大的多天线传输的更多个资源)指派给在该系统中服务的每个WCD。
さらに、一態様においては、プロセッサ406は、送信ダイバーシティモジュール412が受信されたコンテンツを処理し、処理されたコンテンツに応答して制御情報を生成し、送信ダイバーシティ方式を用いて制御情報を送信するための2つの又はそれより多い送信アンテナと関連づけられた2つの又はそれより多いリソースを割り当て、割り当てられたリソースへの巡回シフトデルタパラメータを決定し、及び決定された割り当てられたリソースに制御情報を割り当てることを可能にするための手段を提供することができる。	此外，在一个方面中，处理器 406可以提供模块来允许发射分集模块 412处理接收的内容、响应于所处理的内容生成控制信息、分配与两个或更多个发射天线相关联的两个或更多个资源用于使用发射分集方案发送控制信息、针对所分配的资源确定循环移位增量参数以及将控制信息指派给所确定的分配的资源。
6. 前記無線手術室通信システムは、システム同期の間に、複数の周波数チャネルの特性を測定、評価し、最高評価の周波数チャネルを前記異なるチャネルとして、その上でカメラビデオ信号を送信するために前記無線ビデオ送信装置に割り当て、別の周波数チャネルを、その上で事前に記録されたビデオ信号を送信するために前記無線記憶ビデオ送信装置に割り当てることを特徴とする請求項5に記載の無線手術室通信システム。	6. 根据权利要求 5所述的无线手术室通信系统，其中在系统同步期间，所述无线手术室通信系统确定和评价多个频率信道的特性，并且向所述无线视频发射器单元指派最高评价频率信道作为不同的信道，以便在其上传输摄像机视频信号，并且向所述无线存储视频发射单元指派另一频率信道，以便在其上传输预记录的视频信号。
反対に、ACK SNフィールドが、このレポートに示される最初の見失われたPDUよりも大きいシーケンス番号を含む場合、これは、アクセス端末202が完全ステータス・レポートを送信したか、そうでない場合には、すべての部分的ステータス・レポートの送信を完了したことを示し、結果として、基地局202は、この目的のために、（許可構成要素214によって）さらなるUL許可を提供する必要も、割り当てる必要もないことを示しうる。	 相反，如果 ACK_SN字段含有大于所述报告中指示的第一遗漏 PDU的序号，那么此可提供接入终端 202已发送完整状态报告或替代地已完成所有部分状态报告的发射的指示，且因此基站 202(经由准予组件 214)无需为此目的供应或分配其它 UL准予。
双方の場合において、我々は、直交パイロットシーケンスを異なる送信機に割り当てる。	在这两种情形中，我们把正交导引序列指派给不同的发射机。
換言すれば、このように提供されるアフィニティ・アドレスは、サーバ・アプリケーション・プログラムの所与のインスタンス204、205、206に一時的にのみ割り当てることができる。	 换句话说，以此方式提供的仿射地址可仅临时分配到给定服务器应用程序实例 204、205和 206。
図1は多数のテレビ受像機104および112を示しているが、コンテンツソース102からのコンテンツの伝送に関する説明は、テレビ受像機104に対するコンテンツの送達に焦点を当てる。	虽然图 1图解说明多个电视接收器 104和 112，但关于内容从内容源 102的发射的描述将聚焦于内容到电视接收器 104的递送。
一態様においては、リソース割り当てモジュール414は、送信ダイバーシティ方式を用いて送信される制御情報に複数のリソースを割り当てるために動作可能であることができる。	在一个方面中，资源分配模块 414可以操作为将多个资源分配给要使用发射分集方案发送的控制信息。
リソースの数を制御するために、送信ダイバーシティモジュール（112、122）は、異なる巡回シフトを有する異なるリソース間での最小の時間領域分離を決定する適切な巡回シフトデルタパラメータを割り当てることができる。	为了控制多个资源，发射分集模块 (112、122)可以指派合适的循环移位增量 (delta)参数，该循环移位增量参数可以确定采用不同循环移位的不同资源之间的最小时域间隔。
送信ダイバーシティを実装するために、少なくとも2つの該リソース（又は、例えば、より大きい多アンテナ送信に関してはそれよりも多い）を、システム内においてサービスが提供される各WCDに対して割り当てることができる。	为了实现发射分集，可以将至少两个这样的资源(或者，例如，用于更大的多天线传输的更多个资源)指派给在该系统中服务的每个WCD。
本発明の一実施形態において、我々は、基本的には直交パイロットシーケンスを送信機に割り当てることにより、DVB−T2 SFNにおける送信機の存在を依然としてウォータマークするが、我々は、OFDM領域におけるDVB−T2信号をもつWMシーケンスを多重する、即ち、時間又は周波数多重することからなる非常に異なるアプローチを用いる。	在本发明的实施例中，我们仍旧通过基本上指派正交导引序列给发射机，而在DVB-T2 SFN中给发射机的存在加水印，但我们使用完全不同的方法，它包含在 OFDM域中复用，即，时间或频率复用 WM序列与 DVB-T2信号。
対照的に、参照数字206において、WCDが送信ダイバーシティ方式を用いて通信することが可能であることが決定された場合は、参照数字212において、同意された送信ダイバーシティ方式を実装することができ、及び、一態様においては、生成された応答を通信するために複数のリソースを割り当てることができる。	相反，如果在参考标号 206处，确定 WCD能够使用发射分集方案进行通信，则在参考标号 212处，可以实现达成一致的发射分集方案，并且在一个方面中，可以分配多个资源用于传送所生成的响应。
さらに、一態様においては、プロセッサ406は、送信ダイバーシティモジュール412が受信されたコンテンツを処理し、処理されたコンテンツに応答して制御情報を生成し、送信ダイバーシティ方式を用いて制御情報を送信するための2つの又はそれより多い送信アンテナと関連づけられた2つの又はそれより多いリソースを割り当て、割り当てられたリソースへの巡回シフトデルタパラメータを決定し、及び決定された割り当てられたリソースに制御情報を割り当てることを可能にするための手段を提供することができる。	此外，在一个方面中，处理器 406可以提供模块来允许发射分集模块 412处理接收的内容、响应于所处理的内容生成控制信息、分配与两个或更多个发射天线相关联的两个或更多个资源用于使用发射分集方案发送控制信息、针对所分配的资源确定循环移位增量参数以及将控制信息指派给所确定的分配的资源。
参照数字206において、WCDが送信ダイバーシティ方式を用いて通信することが可能でないことが決定された場合は、参照数字208において、制御情報の通信のために単一のリソースを割り当てることができ、参照数字210において、単一のリソース応答を送信することができる。	如果在参考标号 206处，确定 WCD不能使用发射分集方案进行通信，则在参考标号 208处，可以分配单一的资源用于控制信息通信，并且在参考标号 210处，可以发送该单一的资源响应。
6. 前記無線手術室通信システムは、システム同期の間に、複数の周波数チャネルの特性を測定、評価し、最高評価の周波数チャネルを前記異なるチャネルとして、その上でカメラビデオ信号を送信するために前記無線ビデオ送信装置に割り当て、別の周波数チャネルを、その上で事前に記録されたビデオ信号を送信するために前記無線記憶ビデオ送信装置に割り当てることを特徴とする請求項5に記載の無線手術室通信システム。	6. 根据权利要求 5所述的无线手术室通信系统，其中在系统同步期间，所述无线手术室通信系统确定和评价多个频率信道的特性，并且向所述无线视频发射器单元指派最高评价频率信道作为不同的信道，以便在其上传输摄像机视频信号，并且向所述无线存储视频发射单元指派另一频率信道，以便在其上传输预记录的视频信号。
このプログラムは、コンピュータが、入力アダプタを介して含まれる特定の入力信号を運ぶビットストリームを受信するとき、コンピュータが適切なバッファにメモリを割り当てるとともに他の適切な資源を利用し、図4および5に関連して記載した様々な動作を実行するように機能して、特定の出力信号を運ぶビットストリームを出力アダプタを介して送信する命令から構成されている。	程序由指令组成，使得当计算机通过输入适配器来接收传送涉及的特定输入信号的比特流时，计算机对适当的缓冲器分配存储器，并且利用其它适当的资源和功能来执行以上参考图 4和图 5描述的各种操作，并且通过输出适配器来发射传送特定输出信号的比特流。
反対に、ACK SNフィールドが、このレポートに示される最初の見失われたPDUよりも大きいシーケンス番号を含む場合、これは、アクセス端末202が完全ステータス・レポートを送信したか、そうでない場合には、すべての部分的ステータス・レポートの送信を完了したことを示し、結果として、基地局202は、この目的のために、（許可構成要素214によって）さらなるUL許可を提供する必要も、割り当てる必要もないことを示しうる。	 相反，如果 ACK_SN字段含有大于所述报告中指示的第一遗漏 PDU的序号，那么此可提供接入终端 202已发送完整状态报告或替代地已完成所有部分状态报告的发射的指示，且因此基站 202(经由准予组件 214)无需为此目的供应或分配其它 UL准予。
縫い目を縫い合わせる．	缝一道缝儿。
衣服のわきを縫い合わせる．	煞裉
在庫の有無を問い合わせる。	询问库存的有无。
仕様について問い合わせること。	询问样式。
見積もりについて問い合わせる	就估价进行询问
工事予定について問い合わせる。	关于工程计划的询问。
博物館のツアーについて問い合わせるため。	为了咨询博物馆的参观。
練り歯磨きの試供品について問い合わせること。	就牙膏的样品进行询问。
例えば管理サーバ装置2に対して管理構造の種別を問い合わせる。	例如，询问管理服务器装置 2关于管理结构的类型。
このことは、例えば、DNSサーバーにホームエージェントのネットワーク内のIPアドレスを問い合わせる（例えば、「homeagents．example．com」といった事前に構成されたDNS名を問い合わせる）ことによって、達成されてもよい。	例如，这可以通过针对网络中的归属代理的 IP地址而查询 DNS服务器 (例如，查询如“homeagents.example.com”的预配置的 DNS名称 )来完成。
具体的には、ソケットAPIラッパ307は、ログインアプリ301に対してMFP101に現在ログインしているユーザの識別情報を問い合わせる。	具体地说，套接字 API包装 307向登录应用 301查询当前已经登录到 MFP 101的用户的标识信息。
問合せ手段は、利用者からの指示に応答して、画像形成装置に対し、そのセキュリティに関する設定を問合わせる。	查询装置响应于来自利用者的指示，向图像形成装置查询关于其安全的设定。
21. 前記プロセッサは、前記メタデータを取得するために前記デバイスに問合せるように構成される、請求項19に記載の装置。	21.如权利要求 19所述的装置，其中，所述处理器用于查询所述设备以获得所述元数据。
未登録を検知すると、機器管理部1121は、この制御化機器125を登録するか否かをユーザに問い合わせる（S106、S107）。	当检测到没有注册时，设备管理单元 1121询问用户是否注册此控制兼容设备 125(S106，S107)。
例えば、コンテキストの条件（例えば、コークボトル温度＞92Fで曇り）が満たされているかどうかを推論器に問い合わせることが可能である。	例如，可以询问推理器上下文条件 (例如，可乐瓶温度＞ 92F且多云 )是否已满足。
矢印104で示されているように、コードエントリモジュール103はユーザ識別データベース105に問合せる。	代码入口模块 103询问，如图中箭头 104所示，用户身份数据库 105。
クエリ・メッセージは、クエリ・メッセージに含まれるGroupAddrによって識別されるマルチキャスト・サービスを受信するMSが存在するかを問い合わせるために使用される。	 该查询消息用于查询是否存在任何MS接收由查询消息中的组址识别的多播服务。
そのような場合、プログラム330は、取り出したルーティングおよびインターフェース情報を表示し（ステップ470）、このルーティングおよびインターフェース情報を使用したいかどうか管理者に問い合わせる（判断474）。	 在这种情况下，程序 330显示取回的路由和接口信息 (步骤 470)，随后询问管理员他是否想要使用该路由和接口信息 (判定 474)。
変更についてメッセージ18の元の送信者に問い合わせることなく、メッセージ18に直接変更を施すようにサーバ10を構成することも可能であると考えられる。	 服务器 10可被配置为直接对消息 18进行改变，而不向消息 18的初始发送方询问这些改变。
いずれの印刷指示においても、セキュリティ設定については共通の画像形成装置に問合せるため、統一したセキュリティ管理が可能になる。	在任意的打印指示中，关于安全设定均向共同的图像形成装置查询，因此可以进行统一的安全管理。
従来のメッセージングアプリケーションとは対照的に、図1に示される実施形態は、ユーザが直ちにメッセージを送信することを希望するかどうかを問い合わせるメニュー表示を提示する、ステップ110。	相比于常规消息接发应用，图 1中解说的实施例呈现一询问用户是否希望立即传送消息的菜单显示 (步骤 110)。
より具体的には、図5に示されるように、ネットワーク複合機1がwindows sizeがゼロのACK（win＝0）を返すと、PC30は、受信バッファ100fが空いたか否かを問い合わせる信号TCP Zero Window Probe（win＝0）を定期的に送出する。	更具体地说，如图 5所示，当网络复合机 1返回 windows size为 0的 ACK(win＝0)时，PC30定期送出询问接收缓冲器 100f是否为空的信号 TCP Zero Window Probe(win＝ 0)。
次に、ステップS218では、PC30から受信バッファ100fが空いたか否かを問い合わせる信号TCP Zero Window Probe（win＝0）が受信されたか否かについての判断が行われる。	接着，在步骤 S218中，进行是否从 PC30接收到询问接收缓冲器 100f是否为空的信号 TCP Zero Window Probe(win＝ 0)的判断。
14. 前記命令は、前記プロセッサに、位置情報が前記発呼者から受信されたかに関して問い合わせるメッセージを前記受信装置から受信するように指示する、請求項10記載のシステム。	14.如权利要求 10所述的系统，其特征在于，所述指令还使所述处理器接收来自所述接收者设备的消息，该消息询问是否已接收到来自所述呼叫者设备的任何位置信息。
デバイスBは、デバイスCによって提供されるサービスについて問い合わせる調査要求を送信し、デバイスCからプローブ応答722（図示せず）を受信してもよい。	设备 B可以发送查询关于由设备 C提供的服务的探测请求，继而，接收来自设备 C的探测响应 722(未示出 )。
レジストレーション要求がS−CSCFによって受信されると、メッセージフローパス468に示すチャレンジ要求によって示されるように、S−CSCF244は、許可および認証のための関連情報を検索するためにHSS238に問い合わせる。	一旦 S-CSCF接收到 REGISTER请求，则 S-CSCF 244查询 HSS238以检索用于授权和认证的相关信息，如在消息流路径 468中所示的挑战请求 (Challenge request)所示。
信すべきか判断するためにHSS238に問い合わせる。 I−CSCF242はまた、第2のレジストレーション要求においてUE104によって与えられたプライベートID1とともに認証情報を検証することができ得る。	I-CSCF 242也可以随同由 UE 104在第二 REGISTER请求中提供的私有 ID1一起地验证认证信息。
検索部105は、中継端末21の登録部200あるいは制御端末22の登録部300と通信し、デバイス使用部100が使用する予定のデバイス41がそれら端末に接続されているか否かを問い合わせる。	检索部 105与中继终端 21的登录部 200或者控制终端 22的登录部 300进行通信，查询设备使用部 100使用的预定设备 41是否连接在那些终端上。
検索部201は、制御端末22の登録部300と通信し、デバイス使用部100が使用する予定のデバイス41が制御端末22に接続されているか否かを問い合わせる。	检索部 201和控制终端22的登录部 300进行通信，查询设备使用部 100使用的预定设备 41是否连接在控制终端22上。
次に、使用可否判断部301は、デバイス41が使用可能であるか否かをデバイス41に問い合わせることにより調査し（S1202）、使用不可能である場合、その旨を通知部305を介してサーバ11に通知する（S1203のNo）。	接着，使用可否判断部 301通过向设备 41查询设备 41是否能够使用，进行调查 (S1202)，在不能使用时，将其意思经由通知部 305通知给服务器 11(S1203的否 )。
出力種別が外部転送で（ステップS602；外部転送）、転送先が他の複合機10の場合は（ステップS617；MFP）、転送先の複合機10に消色トナーによる印刷が可能であるか否かを問い合わせる（ステップS621）。	在输出种类为外部传送 (步骤 S602；外部传送 )且传送目的地为其他的复合机 10的情况下 (步骤 S617；MFP)，询问传送目的地的复合机 10是否可使用脱色调色剂进行印刷(步骤 S621)。
出力種別が外部転送で（ステップS801；外部転送）、転送先が他の複合機10の場合は（ステップS811；MFP）、転送先の複合機10に消色トナーによる印刷が可能であるか否かを問い合わせる（ステップS813）。	在输出种类为外部传送 (步骤 S801；外部传送 )且传送目的地为其他的复合机 10的情况下 (步骤 S811；MFP)，询问传送目的地的复合机 10是否可使用脱色调色剂进行印刷(步骤 S813)。
具体的には、印刷装置110に含まれるプリント処理管理部117は、印刷装置110のネットワーク処理部111を介して、印刷すべきプリントデータの有無を定期的にクラウドプリントサービス101へ問い合わせる。	更具体地说，打印装置 110中包括的打印处理管理器 117周期性地将关于是否存在待打印的打印数据的询问，经由打印装置 110的网络处理器 111发送至云打印服务 101。
SIPを用いて通信する場合、送信側端末と受信側端末との間にSIPサーバが備えられ、送信側端末は、SIPサーバに対して受信側端末のIPアドレスを問い合わせることにより該IPアドレスを取得し、受信側端末に対して接続を要求する。	在使用 SIP进行通信的情况下，将 SIP服务器设置在发送方侧终端和接收方侧终端之间，并且发送方侧终端向 SIP服务器询问接收方侧终端的 IP地址，从而获取该 IP地址并请求接收方侧终端进行连接。
さらにカメラ制御部20は、このとき検出した現在のカメラ位置及びカメラ方向で写真撮影可能な他対象物の写真撮影用に、他対象物撮影条件が提供可能であるか否かを問い合わせるための問合信号を生成する。	另外，照相机控制器 20生成询问信号，用于询问是否能够提供用于拍摄可能在检测的当前照相机位置和照相机方向拍摄的非人对象的非人对象摄影条件。
プログラム330はさらに、失敗した通信を許可するルールを含まなかったどのファイアウォールについても管理者に通知し、このファイアウォールが、失敗した通信を許可するようなルールを備える必要があるかどうかを管理者に問い合わせる。	 程序 330还通知管理员不包括许可所述故障通信的规则的任何防火墙，并询问管理员所述防火墙是否应当包括许可所述故障通信的这CN  10202771227 AA 说  明  书 6/8页种规则。
プログラム330が送信元デバイスおよび宛先デバイスからルーティングおよびインターフェース情報を何ら取り出すことができなければ（判断460、いいえの分岐）、プログラム330は、ルーティングおよびインターフェース情報を手動で入力するように管理者に問い合わせる（ステップ464）。	对于程序 330不能从源设备和目的地设备取回的任何路由和接口信息 (判定460，“否”分支 )，程序 330询问管理员手动输入该路由和接口信息 (步骤 464)。
ステップ916にて、プログラム330はさらに、失敗した通信を許可するルールを含まなかったどのファイアウォールについても管理者に通知し、このファイアウォールが、失敗した通信を許可するようなルールを備える必要があるかどうかを管理者に問い合わせる。	 在步骤916，程序 330还通知管理员不包括许可故障通信的规则的任何防火墙，并询问管理员所述防火墙是否应当包括许可故障通信的这种规则。
このパイロット信号は、1つまたは複数のフェムトAPを介して通信するために使用するEM放射帯域とは別の周波数搬送波の中で運ぶことができ、したがって、著しい干渉を与えることなく、1つまたは複数のRFIDタグ9251〜92510に問い合わせることができる。	 所述前导信号可以在不同于毫微微 AP通信所采用的 EM辐射带的频率载波中传递； 因此，可询问 RFID标签 9251-92510，而不会遭受大的干扰。
画像形成装置で利用者毎のセキュリティ保護設定がされていると判定されたとき（S1112でYES）、情報処理端末は、端末利用者の利用者名が、セキュリティ保護を有効にする利用者として設定されているかを画像形成装置に問合せる（S1114）。	当在图像形成装置中进行了各个利用者的安全保护设定时 (S1112肯定判定 )，信息处理终端向图像形成装置查询终端利用者的利用者姓名是否被设定为使安全保护有效的利用者(S1114)。
（4）前記の実施形態では、携帯機200において、バッテリ30の残量等を問い合せるための機械的な充電照会ボタン25を設けたが、充電照会ボタンを表示部23の画面上に表示し、当該ボタンを操作キー29により操作するようにしてもよい。	(4)在上述实施方式中，在便携机 200上设置有用于询问电池 30余量等的机械式的充电询问按钮25，但也可将充电询问按钮显示在显示部23的画面上，并利用操作键29来操作该按钮。
送信先のドメインとは、メールの宛先メールアドレスのアットマーク（@）より後ろの部分を指し、メールゲートウェイ106は送信先のドメインをDNS(Domain Name System)サーバへ問合せることにより、どのメール転送サーバ105に送信すべきかを判定することができる。	所谓发送目的地的域，是指邮件的目的地邮件地址的单价符号 (atmark)(@)以后的部分，邮件网关 106通过向 DNS(Domain Name System)服务器查询发送目的地的域，可以判定应该向哪个邮件转发服务器 105发送。
例えば、ユーザは、会話を開始することによって（例えば、お勧めのレストランを問い合わせる、インスタントメッセージングセッションを開始する等）、他のユーザとの関係を開始して、興味が共通するデジタルコンテンツ（例えば、音楽、詩歌、文学、映画、絵画等）を共有することができる。	例如，用户可能通过启动会话 (例如，查询其它餐馆建议，启动即时消息会话等 )来设法启动同另一个用户的关系，以便共享共同兴趣的数字内容 (例如，音乐、诗、文学、电影、图片等 )等。
出力種別が外部転送で（ステップS402；外部転送）、転送先が他の複合機10の場合は（ステップS413；MFP）、ネットワーク通信部20を通じて転送先の複合機10に消色トナーによる印刷が可能であるか否かを問い合わせる（ステップS416）。	在输出种类为外部传送 (步骤 S402；外部传送 )且传送目的地为其他的复合机 10的情况下 (步骤 S413；MFP)，通过网络通信部 20询问传送目的地的复合机 10是否可使用脱色调色剂进行印刷 (步骤 S416)。
例えば、図2に示したMPファイル内の画像2a−2が印刷対象として指定された場合には、CPU106は、使用者に対して画像2a−2のみを印刷するか、あるいは画像2a−2、画像2b−2、画像2c−2、および画像2d−2をStitchingして得たパノラマ画像を印刷するかを問い合わせる。	例如，当图 2所示的 MP文件内的图像 2a-2被指定为印刷对象时，CPU106询问使用者，是仅印刷图像 2a-2，还是印刷将图像 2a-2、图像 2b-2、图像 2c-2及图像 2d-2缝合而获得的全景图像。
ステップS350では、CPU106は、使用者に対して、指定された個別画像のみを再生するか、あるいはMPファイル内の各個別画像をStitching（結合）して得たパノラマ画像を再生するかを問い合わせるためのメッセージを画面上に表示する。	在步骤 S350中，CPU106将对使用者询问的消息显示到画面上，以询问是仅重放指定的独立图像，还是重放将 MP文件内的独立图像缝合 (结合 )所得的全景图像。
あるいは、使用者に対してその都度問い合わせるのではなく、予め使用者が個別画像のみを印刷するか、各個別画像をStitchingして得たパノラマ画像を印刷するかを設定できるようにし、CPU106は、その設定に基づいて、個別画像またはパノラマ画像を印刷するようにしてもよい。	或者，不是每次都询问使用者，而是预先由使用者设定只印刷独立图像、还是印刷将各独立图像缝合所得的全景图像，CPU106根据该设定，印刷独立图像或全景图像。
あるいは、使用者に対してその都度問い合わせるのではなく、予め使用者が個別画像のみを再生するか、各個別画像をStitchingして得たパノラマ画像を再生するかを設定できるようにし、CPU106は、その設定に基づいて、個別画像またはパノラマ画像を再生するようにしてもよい。	或者，不是每次都询问使用者，而预先由使用者设定只重放独立图像、还是重放将各独立图像缝合所得的全景图像，CPU106根据该设定，重放独立图像或全景图像。
本発明の実施形態では、IGMPプロキシは、ホスト204−3のグループ・メンバーシップ状態、すなわちホスト204−3が属する複数のグループのうちの特定のグループにおけるホスト204−3の状態を問い合わせるために、イーサネット（登録商標）・スイッチ202−2を通じてホスト204−3にマルチキャスト・グループ管理状態メッセージを送る。	在本发明实施例中，IGMP代理通过以太网开关 202-2向主机 204-3发送组播组管理状态消息，以查询主机 204-3的组成员状态，即主机 204-3在它所属的多个组的特定组中的状态。
TD＿HA114は、盗難防止プロトコルにおいてクライアント装置102のTD＿ME112を支援するように構築され、盗難防止プロトコルは、例えばネットワーク104がアクセス可能であるか否かを判断すること、TD＿SVC122からのメッセージを中間サーバ108に問い合わせること及び／又はメッセージをTD＿ME112に中継すること等を含む。	TD HA 114可以被配置为在阻止盗窃协议中帮助客户端设备 102中的 TD ME 112，例如包括： 确定网络 104是否是可访问的、向中间服务器 108查询来自 TD SVC122的消息，和 /或将消息中继到 TD ME 112。
会社の慰安旅行に行きます。	去参加公司的慰劳旅行。
彼が少し悲しそうであるのを見て，彼を慰めるうそをついた．	因为看他有些凄然，便说了一个
3. 前記受信アンテナは、直接放射アレイアンテナ、アレイフィードリフレクタアンテナ、またはイメージングフェーズドアレイアンテナであることを特徴とする請求項1または2に記載の方法。	3.根据权利要求 1或 2所述的方法，其中，所述接收天线包括直接辐射阵列天线、阵馈反射面天线或成像相控阵天线。
12. 前記受信アンテナは、直接放射アレイアンテナ、アレイフィードリフレクタアンテナ、またはイメージングフェーズドアレイアンテナであることを特徴とする請求項11に記載の装置。	12.根据权利要求 11所述的装置，其中，所述接收天线包括直接辐射阵列天线、阵馈反射面天线或成像相控阵天线。
いいか？—いいよ！	中不中？—中！
いいね！	真不错！/赞！
いいえ！	不价！
はい、いいですよ。	好，可以哦。
いい物は高い。	好东西贵。
いいんじゃない？	不觉得很好吗？
痛い！	好疼！
Aでもいいし、Bでもいい。	A也可以，B可也以。
名医．	名医
いいですか？	可以吗？
いいですよね？	可以吧？
いいですね。	真好啊。
へぇ、いいな。	哎，真好啊。
いいもん。	好东西。
なんでもいい。	怎么都好。
いい気味だ。	感觉不错。
いい空です。	很美的天空。
どうでもいい。	随便。
どっちがいい？	哪个好？
調子がいい	状态很好
仲がいい	关系好。
別にいいです。	没关系。
もういいよ。	已经够了。
いいですよ。	好啊。
美容にいい。	对美容好。
いいですよ。	可以哦。
かわいい！	好可爱！
いいと思う。	我觉得很好。
かっこいいです。	好帅。
かっこいいよ。	帅。
私でいいの？	我可以吗？
なにがいい？	要什么？
いい夢を！	祝你好梦！
いいですよ。	没关系哦。
かっこいいね。	真帅呢。
顔がいい	脸很好
いい気味だ。	痛快。
頭がいい。	你很聪明。
いい夢を。	祝好梦。
いいセンスだ。	品味很好。
いいでしょ？	好吧？
いいなー。	真好啊。
いいねしたよ。	我点赞了。
いいよね。	可以吧。
いいんですよ。	可以啊。
いい写真	很好的照片
いい旅を。	祝你旅途愉快。
すごくいいよ。	很好哦。
それがいい。	那样好。
それはいい！	那样好！
善い行いをする。	做好事。
率先して善い事をする．	争先做好事。
大衆のために善いことをする．	为群众做好事。
子供が昨日善い事を一つした．	孩子昨天做了一桩好事。
善い事をすれば善い報いがあり，悪い事をすれば悪い報いがある．	善有善报，恶有恶报。((ことわざ))
善い事をすれば善い報いがあり，悪い事をすれば悪い報いがある．	善有善报，恶有恶报。((ことわざ))
因果応報，善い行ないをした人には善い報いがあり悪い行ないをした人には悪い報いがある．	因果报应((成語))
前世で功徳を積むと，現世には善い報いがある．	上辈子积德，这辈子有好报应。
おばあさんはしょっちゅう善いことをしている．	奶奶经常行善。
私たちはこの問題に対して次からは改善いたします。	我们会对这个问题做以下改善。
過ちを犯して改めることができるのは，これより善いことはない．	过而能改，善莫大焉。
（悪人が悪事を働くの見て憤慨して言う場合の）悪人は到底善いことはやれない．	恶人难行善事((成語))
これは良い。	这个好。
良いですか？	可以吗？
性格が良い。	性格很好。
良いでしょ？	很好吧？
治安が良い。	治安很好。
良いですね。	不错呢。
景色が良い。	景色好。
見た目が良い。	外表很好。
元気が良い。	有精神。
極めて良い．	好极了
何時でも良いです。	几点都行。
何時が良いですか？	几点可以？
良い休日を。	休息日愉快。
油ぎれが良い。	防油性好。
これは格好良い。	这个好酷。
良い旅を！	祝你有个愉快的旅行。
心地良い一日	舒适的一天
操作性が良い。	操作性很好。
着心地が良い。	穿着很舒服。
それらは良いです。	那些很好。
良いものの1つ	1个好东西
良い日だった。	今天很美好的一天。
良い空の旅を。	祝你飞行愉快。
良い週末を。	祝你周末愉快！
センスが良いね。	眼光很好。
良い週末を！	周末愉快！
良い夢を見れた？	做了个好梦？
～したほうが良い。	做~比较好。
ここ良いよね。	这里不错呢。
良い週末を。	祝你周末愉快。
良い朝です。	是个美好的早晨。
血の巡りが良い。	血液循环好。
良いお年を。	祝您过个好年。
良いセンスです。	你很有品位。
しても良いですか？	可以做吗？
配色が良い．	配色配得好。
体調は良いですか？	身体还好吗？
日当たりの良い部屋	光照条件好的屋子
良い薬はありますか？	有好药吗？
行っても良いですか？	可以去吗？
ちょうど良い価格だね。	正好的价格呢。
今日は天気が良い。	今天天气好。
涼しくて気持ちが良い。	非常理解了。
使って良いですか？	可以用吗？
どちらでも良いです。	哪个都好。
どうしたら良いですか？	怎么办才好？
どちらでも良いよ。	不管哪个都不错哦。
良い夢を見て下さい。	请做个好梦。
キャンセルで良いですか？	确定要删除吗？
ゆっくりして良いよ。	慢慢来就可以哦。
共同で発言する．	联合发言
（多く冷やかして言う場合の）年をとって若作りする．	老来俏((貶し言葉))
ゆっくりと言う言葉が基本で、丁寧な言い方をする場合にごゆっくりと言います。	慢慢说话是基本，礼貌地说话的时候要慢慢地说。
あなたとそのことで言い合いをするつもりは無かった。	我并没有打算和你因为那件事情吵架。
彼の言うことはすることと合わない．	他说的和做的不对号。
具体的には、発言内容蓄積部（登録部）19は、発言内容DB29に発言単語を格納した場合、この発言単語が所定の条件を満たすか否かを判断し、所定の条件を満たす場合に、この発言単語を、対応する会議のキーワードとしてキーワードDB27に登録する。	具体来说，发言内容积存部 (登记部 )19在中发言内容 DB29存储了发言单词的情况下，判断该发言单词是否满足规定的条件，在满足规定的条件的情况下，将该发言单词作为对应的会议的关键字登记到关键字 DB27中。
また、発言内容蓄積部19は、参加者のいずれかの発言単語を発言内容DB29に蓄積した場合に、蓄積した発言単語が、新たなキーワードとしてキーワードDB27に登録すべきであるか否かを判断する。	另外，发言内容积存部 19在将参加者的任意一个发言单词积存到发言内容 DB29中的情况下，判断所积存的发言单词是否应作为新的关键字登记到关键字DB27。
このほかに、例えば、実施形態2の会議サーバ1のように発言者を特定する機能を備える場合、各発言者の一連の発言毎に、各発言にキーワードが含まれているか否かを判定してもよい。	除此以外，例如，可以在实施方式 2的会议服务器 1那样在具有确定发言者的功能的情况下，每当各发言者一连串的发言时，判定各发言中是否含有关键字。
話をする時は度合いを越えないように注意すべきで，言葉遣いは過激になってはいけない．	说话时要注意分寸，言辞不要过激。
具体的には、まず、AF処理部109において、合焦評価値を算出する。	具体而言，首先在 AF处理部 109计算对焦评价值。
上司は私に午前10時の打合せに出席するように言った。	上司让我出席上午10点的会谈。
親指を立てる（人を褒める場合や「最高だ」と言う時にする動作）．	翘起大拇指伸出大拇指坚起大拇指
彼女はとっさには彼に反撃する適当な言葉が見つからなかった．	她一时找不出合适的话来回击他。
君は君の事だけを言うんだ，彼をかかわり合いにするな．	你只说你的事，别把他攀扯进去。
彼を引き合いにして冗談を言う，彼をからかう，彼を冗談の種にする．	拿他开玩笑。
本発明の態様に関する操作を実行するためのコンピュータ・プログラム・コードは、Java、SmallTalk、C＋＋などのようなオブジェクト指向型プログラミング言語、及び、「C」プログラミング言語又は同様のプログラミング言語のような従来の手続き型プログラミング言語を含む1つ又は複数のプログラミング言語の任意の組み合わせで書くことができる。	用于执行本发明诸方面的操作的计算机程序代码，可以以一种或多种编程语言的任何组合来编写，编程语言包括面向对象的编程语言，诸如 Java、Smalltalk、C++之类，还包括常规的过程式编程语言，诸如“C”编程语言或类似的编程语言。
本発明の諸態様に関する動作を実施するためのコンピュータ・プログラム・コードは、Java（R）、Smalltalk（TM）、またはC＋＋（R）などのオブジェクト指向プログラミング言語、および、「C」プログラミング言語または同様のプログラミング言語などの従来の手続き型プログラミング言語を含む、1つまたは複数のプログラミング言語の任意の組み合わせで作成可能である。	用于执行本发明方面的操作的计算机程序码，可以以一种或多种编程语言的任何组合来编写，所述编程语言包括面向对象的编程语言 -诸如 Java、Smalltalk、C++之类，还包括常规的过程式编程语言 -诸如“C”编程语言或类似的编程语言。
また、発言者を特定する機能を備えない場合であっても、例えば、会議サーバ1の制御部10が、発言者による発言が途切れてからの時間を計測し、予め設定された時間が経過した場合に、発言者が代わったと判断してもよい。	另外，即使在不具备确定发言者的功能的情况下，例如，会议服务器 1的控制部 10计算从发言者的发言中断起的时间，当经过了预先设定的时间的情况下，判断为更换了发言者。
RPLL1515の代わりにDPLL1615を使用することにより、周波数合成器1610は、図15の周波数合成器1510よりも電力消費量を低減することが可能になる。	使用 DPLL1615来代替 RPLL1515允许频率合成器 1610相比图 15中的频率合成器 1510而言缩减了功耗。
本発明の諸動作を実行するためのコンピュータ・プログラム・コードは、Java、Smalltalk、C＋＋などのオブジェクト指向プログラミング言語、および、「C」プログラミング言語または同様のプログラミング言語などの従来の手続き型プログラミング言語を含む、1つまたは複数のプログラミング言語の任意の組み合わせで作成することができる。	用于执行本发明操作的计算机程序代码可以通过一个或多个编程语言的任意组合进行编写，包括面向对象的编程语言 (诸如，Java、Smalltalk、C++等 )和常规过程编程语言 (诸如，“C”编程语言或类似编程语言 )。
集約MACパケット216を、時に、集約MACプロトコルデータユニット（AMPDU）として言及する。	集合 MAC包 216有时被称作集合 MAC协议数据单元 (AMPDU)。
本発明の実施形態の動作を実行するコンピュータ・プログラム・コードは、Java（R）、Smalltalk、C＋＋などのオブジェクト指向プログラミング言語、「C」プログラミング言語などの従来の手続き形プログラミング言語、または同様のプログラミング言語など、1つまたは複数のプログラミング言語の任意の組合せで書き込むことができる。	用于执行本发明的实施例的操作的计算机程序代码可以通过一种或多种编程语言的任意组合进行编写，所述编程语言包括诸如 Java、Smaltalk、C++之类的面向对象的编程语言以及诸如“C”编程语言或类似的编程语言之类的传统过程编程语言。
開示された動作を実行するコンピュータ・プログラム・コードは、Java（R）、Smalltalk（R）、C＋＋などといったオブジェクト指向プログラミング言語、ならびに「C」プログラミング言語または同様のプログラミング言語などの従来型手続きプログラミング言語を含む、1つ以上のプログラミング言語の任意の組み合わせで書かれるとよい。	用于执行所公开操作的计算机程序代码可以以一个或者多个编程语言的任何结合编写，包括面向对象编程语言 (诸如Java、Smalltalk、C++等 )和传统的过程编程语言 (诸如，“C”编程语言或者类似编程语言 )。
具体的には、輝度成分における合成比率よりも色差成分における合成比率を高めに設定する。	具体而言，与亮度成分的合成比例相比，色差成分的合成比例设定得较高。
換言すると、この場合には関連する制御オーバヘッドを最小化することができる、または0に調節することもできるので、eNBがUE1にサービス提供するのに全てのリソースが利用可能である。	换言之，在此情形中相关联的控制开销能够得以减小或者甚至被调节为零从而使得全部资源可用于 eNB服务于 UE1。
すなわち、レイヤ合成部543は、このように合成により生成された領域E11＋E12の合成画像と、合成画像保持部170に保持されている合成画像に対応するE1とを貼り付ける処理を行う。	换言之，层合成部件 543执行如下的处理，其中将如上所述通过合成而生成的区域“E11+E12”的合成图像与对应于在合成图像保持单元 170中保持的合成图像的 E1附接在一起。
ACK／NACK比率が指定された閾値を下回る場合、WTRU102はRL障害を宣言することができる。	如果 ACK/NACK比值低于规定阈值，那么 WTRU 102可以宣告 RL故障。
英語での適切な意味を表現するには "I have decided to get married."と言わなくてはならない。	在英语中为了表现出合适的意思，必须说"I have decided to get married."
言葉を話したり文章を書く場合，単語の違った用法を区別することに注意を払わねばならない．	说话和写文章，要注意分辨词的不同用法。
彼が他人に対して何か言おうとする場合，（相手の顔をつぶしたくないので）どうしても強く出られない．	他给别人说点什么，从来就抹不下脸来。
（言葉・事柄が）見当がつかない，つかみどころがない，（行為をする場合）見境がない，やぶからぼうに，だしぬけに．	没头没脑
（消費水準について言う場合の）衣食に対する要求を基本的に満足させられる程度．	温饱型
彼の言うこの状況は我々の持っている証拠と完全に一致する．	他说的这个情况跟我们掌握的证据完全吻合。
換言すると、1次コイルと2コイルの位置合わせ精度が電力伝送効率に大きく影響を与える。	换言之，初级线圈和次级线圈的对准的精度极大地影响功率传输效率。
言い換えると、NCPL−80−1400が162に設定される場合、受信器の80％は1つのパケットを少なくとも受信する。	换言之，如果 NCPL-80-1400被设置为 162，则 80％的接收机将至少接收一个分组。
Linda言語では、「テンプレート」と呼ばれる構成物(constructs)は、技術を整合することを介してタプルを関連づけられて取り組むために使用される。	在类 Linda语言中，称为“模板”的构造被用于经由匹配技术来相联地寻址元组。
たとえば、英語を話す参加者が中国東海岸に住む人々に質問がある場合、変換サービス16を備えるウェブ・サービス・ホスト14は、言語およびドメインに最も合致する小グループに、最終の変換された発言を送信することになる。	 举例而言，说英语的参与者对住在中国东海岸的人有问题，具有翻译服务 16的Web服务主机 14将最终的经翻译语调发送至具有语言及域的最佳匹配的小群组。
すなわち、レイヤ合成部543が、優先順位に基づいて、4つのレイヤ（第1優先画像581乃至第4優先画像584）を合成することにより、合成画像589を生成する。	换言之，层合成部件543通过基于优先级等级来合成四个层 (第一优先级图像 581到第四优先级图像 584)而生成合成图像 589。
すなわち、図19（a）では、合成対象画像592に対応する推移動作有効領域E10と、直前の合成対象画像593とについて合成処理がされた合成画像591とを示す。	换言之，图 19A表示与通过对紧接在前的合成目标图像 593执行合成处理所获取的合成目标图像 592和合成图像 591对应的转变操作有效区域 E10。
その方法は、さらに、各タイミング仮定について、対応する複数の重みを備えた干渉抑制フィルタを使用して、シンボルのバーストの部分集合を濾波すること、及び、選択基準に対応するタイミング仮定の内の1つを選択することを備える。	对于每个时基假言，使用具有对应的多个权重的干扰抑制滤波器对该码元阵发的该子集进行滤波； 以及选择这多个时基假言中对应于选择准则的一个时基假言。
その方法は、さらに、各タイミングの仮定について、対応する複数の重みを備えた干渉抑制フィルタを使用して、シンボルのバーストの部分集合を濾波すること、及び、選択基準に対応する複数のタイミングの仮定のうちの1つを選択することを備える。	对于每个时基假言，使用具有对应的多个权重的干扰抑制滤波器对该码元阵发的该子集进行滤波； 以及选择这多个时基假言中对应于选择准则的一个时基假言。
ここで、対処方法をユーザーに報知する場合、印刷実行部104は、診断部102からの指示に基づいて上記の文言を印刷する。	这里，在将应对方法告知用户时，打印执行部 104按照来自诊断部 102的指示，对上述的语句进行打印。
フラットベッド方式の場合，原稿を1枚ずつコンタクトガラス11（以下，「FBガラス11」とする）上に載置する。	对平板方法 (flat bed method)而言，文稿逐一被放置在接触玻璃 11(以下称之为“FB玻璃 11”)上。
発言者特定部18は、通信部12を介して音声信号を受信した場合、音声信号と共に受信した端末装置4の端末ID又は端末装置4の参加者の参加者IDに基づいて、この音声信号を発言した参加者（発言者）を特定する。	发言者确定部 18在通过通信部 12接收到语音信号的情况下，基于与语音信号一同接收到的终端装置 4的终端 ID或者终端装置 4的参加者的参加者 ID，确定发出该语音信号的参加者 (发言者 )。
換言するに、ライン出力のために必要な合成フィルタリングの処理量が、ライン出力毎に異なる。	换句话说，由于行输出，所需的合成滤波处理量在每一行输出中不同。
「一般的に合理性を有するものとはとうてい考えられない程度」と言っても程度は人によって異なる。	虽然说“不会有一般看来合理性的程度”，但程度因人而异。
換言すると、基地局104及び移動局600は、アプリケーションデータがアプリケーションに該当するQoS処理を受信することを保証するための該当するQoSクラス、帯域幅、及び遅延を有するサービスフロー606を利用することができる。	换句话说，基站 104和移动站 600可以使用具有合适的 QoS等级、带宽和延迟的服务流 606来确保应用数据接收到适合于该应用的 QoS待遇。
該複数の情報ビットを分類した後に、仮定エンジンの仮定APIおよびデリバリーロジック1040は、分類された情報を使用して、複数のAPIビット値のセットまたは複数のセット（各セットが、仮定に対応している）を生成することができる。 例えば、ロジック1040は、APIビット位置を構成することができる。	在将信息比特分类之后，假言引擎的假言 API和递送逻辑 1040可使用经分类的信息生成 API比特值的一个或多个集合 (每个集合对应一假言 )。
本実施形態1の会議サーバ1において、制御部10は、記憶部20に記憶してある制御プログラムを実行することによって、音声認識部14、言語解析部15、判定部16、集計部17等の機能を実現する。	在本实施方式 1的会议服务器 1中，控制部 10通过执行存储部 20所存储的控制程序，实现语音识别部 14、言语解析部 15、判定部 16、合计部 17等的功能。
具体的には、発言者特定部18は、音声信号と共に端末IDを受信した場合、端末・ユーザ管理テーブル23を参照して、受信した端末IDに対応する参加者ID（ユーザID）を特定する。	具体来说，发言者确定部 18在将终端 ID与语音信号一同地接收到的情况下，参照终端和用户管理表格 23，确定与接收到的终端 ID对应参加者 ID(用户 ID)。
これはきっと彼がやったことだ，言い合うまでもない．	这一定是他干的，不消争论。
あれは食べ物でよく言い合う子供だ．	他是个爱争嘴的孩子。
言い換えると、同じPDNのうちの異なるPDNコンテキストのIPフローを、同じRLPフローに割り当てることが望ましい。	换句话来说，需要在同一 RLP流上指派同一 PDN的不同 PDN上下文的 IP流。
言い換えると、同じPDNのうちの異なるPDNコンテキストのIPフローを、同じRLPフローに割り当てることが望ましい。	换句话来说，需要在同一 RLP流上指派同一 PDN的不同 PDN上下文的 IP流。
SDMAの場合、複数のUEには、M個の副搬送波をカバーする同じリソースブロックを割り当てることができる。	对于 SDMA而言，可以给多个 UE分配覆盖 M个子载波的相同资源块。
SDMAの場合、残りの利用可能な循環シフトは、少なくとも1つの他のUEに割り当てることができる。	对于 SDMA而言，可以将其余可用的循环移位分配给至少一个其它 UE。
なお、図5の例では、数字キーに数字およびアルファベットの一字を割り当てるようにしていたが、割当関係はこれに限定されるものではなく、各国言語に応じた割当関係を設定することが可能である。	此外，虽然在图 5的例子中，在数字键上分配数字以及字母的单字，但分配关系并不限定于此，还可以设定与各国语言相应的分配关系。
換言すれば、このように提供されるアフィニティ・アドレスは、サーバ・アプリケーション・プログラムの所与のインスタンス204、205、206に一時的にのみ割り当てることができる。	 换句话说，以此方式提供的仿射地址可仅临时分配到给定服务器应用程序实例 204、205和 206。
それで、使用者は、左手をデジタルカメラに当てる瞬間、自動オンになり、左手をデジタルカメラから離す場合、自動オフになるので、デジタルカメラをより便利に使用することができる。	换言之，当使用者的左手接触数码相机时，数码相机自动开启，而当使用者的左手离开数码相机时，数码相机自动切换为关闭。
具体的には、通信手段判定部308は、重要度4033が”高”、”中”、”低”の各データにそれぞれ、QoSレベル4032の”1”、"2”、”3” を割り当てることを示すテーブル指定情報4034を取得する。	具体而言，通信单元判断部 308取得表示对重要度 4033为“高”、“中”、“低”的各数据分别分配 QoS等级 4032的“1”、“2”、“3”的表指定信息 4034。
この実施では、イコライザ314によって受信された信号は、高いSNRを有しているので、フィンガ・アロケータ312は、復調フィンガを割り当てるために、イコライザ314によってレーキ受信機308によって受信されたキャリアにバイアスをかけうる。	在该实现中，由于由均衡器 314接收的信号可以具有较高的 SNR，所以对于分配解调指状物而言，指状物分配器 312可以相对于均衡器 314的载波偏向经由 rake接收机 308接收的载波。
言い換えれば、ランク・インジケータ（RI）が、適切に復号されず、誤りがある場合、物理アップリンク共有チャネル（PUSCH）送信のさまざまなセグメント（例えば、チャネル品質インジケータ（CQI）、リソースに対応するデータ部分、アクノレッジメント（ACK）等）が誤ったものになるだろう。	换句话说，如果阶层指示符(RI)未被适当地解码且有错误，那么物理上行链路共享信道 (PUSCH)发射的各种区段将有错误 (例如，信道质量指示符 (CQI)、一部分数据 -对应的资源、确认 (ACK)等 )。
言い争ってやめない，いつまでも言い争う．	争辩不休
君たち，これ以上言い争うな．	你们不要再计较了。
理詰めで大いに言い争う．	据理力争
言い争う声がやまない．	哓哓不休((成語))((貶し言葉))
彼は無知で，しょっちゅう理由もなく言い争う．	他没有知识，常常无端与人吵架。
私には彼と言い争うほどの余裕などどこにもない．	我哪有闲心跟他争论？
我々は彼と言い争うまでもない．	咱们不犯跟他争论。
言い争いはやめて，くじで決めよう．	别争了，咱们来抓阄儿。
彼は気の小さい人だから，彼と言い争うな．	他是个小心眼儿的，别计较他。
2人の女の使用人が言い争っている．	两个女佣在相骂。
両方が言い争うと，どうしてもどちらか一方が理に欠けているものだ．	两方面争论，总有一边理屈。
話をしているうちに，2人は面と向かって言い争うようになった．	说着说着，两人就破脸了。
2人が互いに勘定を支払おうとして，わーわーと言い争いになった．	两个人互相让账，吵成一片。
あの2人は譲り合うことは知らないので，顔を赤らめ首に青筋を立てて言い争っている．	他们俩谁也不让谁，争论得脸红脖子粗。
息子の結婚問題のために，夫婦はとめどもなく言い争いを続けている．	为儿子的婚事，夫妻俩在那里争论不休。
彼ら2人がこの問題に言及すると，言い争いが始まっていつまでも終わらない．	他们两个人一谈到这个问题，抬起来就没完。
この争いの中で，一方の言い分ばかり聞いていたのでは，左袒の嫌いを免れない．	在这场争端中，你总听一面之词，难免有左袒之嫌。
君たち，これ以上言い争うな．	你们不要再计较了。
理詰めで大いに言い争う．	据理力争
言い争う声がやまない．	哓哓不休((成語))((貶し言葉))
我々は彼と言い争うまでもない．	咱们不犯跟他争论。
私には彼と言い争うほどの余裕などどこにもない．	我哪有闲心跟他争论？
彼は気の小さい人だから，彼と言い争うな．	他是个小心眼儿的，别计较他。
言い争ってやめない，いつまでも言い争う．	争辩不休
彼は無知で，しょっちゅう理由もなく言い争う．	他没有知识，常常无端与人吵架。
話をしているうちに，2人は面と向かって言い争うようになった．	说着说着，两人就破脸了。
両方が言い争うと，どうしてもどちらか一方が理に欠けているものだ．	两方面争论，总有一边理屈。
言い争う声がやまない．	哓哓不休((成語))((貶し言葉))
君たち，これ以上言い争うな．	你们不要再计较了。
理詰めで大いに言い争う．	据理力争
言い争ってやめない，いつまでも言い争う．	争辩不休
我々は彼と言い争うまでもない．	咱们不犯跟他争论。
私には彼と言い争うほどの余裕などどこにもない．	我哪有闲心跟他争论？
彼は気の小さい人だから，彼と言い争うな．	他是个小心眼儿的，别计较他。
彼は無知で，しょっちゅう理由もなく言い争う．	他没有知识，常常无端与人吵架。
話をしているうちに，2人は面と向かって言い争うようになった．	说着说着，两人就破脸了。
両方が言い争うと，どうしてもどちらか一方が理に欠けているものだ．	两方面争论，总有一边理屈。
周りの景色は言葉で言い表すことができないほど綺麗であった。	周围的景色美得无法用言语来表达了。
私は自分の言いたいことを表わすのに適当な言葉が見つからない．	我找不到贴切的词儿来表达我的意思。
別の言い方をすれば、一方のコンテンツ成分を表す信号は、他方のコンテンツ成分を表す信号よりも進んでいる。	 换言之，分量内容表示信号中的一个相对于另一个是领先的。
中国語で言いたい事を正確に表すにはこの様な単語を上手く使える必要がありますね。	要想用中文正确地表达出自己想说的话，必须能流利地使用这样的词汇。
言い換えれば、式（4）はあらゆる置換画素に対して境界の後の第1の画素の画素値を使用することを表し、式（5）は置換画素値として画素値の重み付け和を使用することを表す。	 换句话说，等式 (4)表示将边界之后的第一像素的像素值用于每一替换像素，且等式 (5)表示将像素值的加权和用于替换像素值。
図1は、例えばユーザ101との対話が可能なゲーム端末又はTVセットといった家電デバイス、言い換えるとCEデバイスである電子デバイス102を有する分散処理システムを表す。	图 1绘出了一种分布式系统，其包括能够与用户 101交互的电子设备 102，例如消费电子设备（CE设备），如游戏机或电视机。
周りの景色は言葉で言い表すことができないほど綺麗であった。	周围的景色美得无法用言语来表达了。
私は自分の言いたいことを表わすのに適当な言葉が見つからない．	我找不到贴切的词儿来表达我的意思。
宣言を発表する．	发表宣言
公告・宣言を発表する．	发表公告
それは言葉で表すことができないほど美しかった。	那个美得无法用言语来表达了。
周りの景色は言葉で言い表すことができないほど綺麗であった。	周围的景色美得无法用言语来表达了。
英語でそれらを表すことばは実際ありません。	用英语表达那些的语言实际上是没有的。
別の言い方をすれば、一方のコンテンツ成分を表す信号は、他方のコンテンツ成分を表す信号よりも進んでいる。	 换言之，分量内容表示信号中的一个相对于另一个是领先的。
社員の語ることは、すべて会社を代表する言葉です。	社员说的话都是代表公司的话。
社員の語ることは、すべて会社を代表する言葉です。	公司员工说的话全部都是代表公司的话。
他の言葉で表すと、フォト4a、4b及び関連付けられた説明3a、3bを表すそれぞれの処理されたコンテンツ5a、5bは、順次的に提示される。	 换句话说，顺序地呈现表示照片 4a、4b以及它们关联的描述 3a、3b的相应的经过处理的内容 5a、5b。
アロヨとワディは世界の異なる地域で使われる同じ地形的特性を表す言葉です。	Arroyo 和 Wadi是世界不同地区描述同一个地形特征的词语
換言すれば、離散的フーリエ変換器503は、一連の周波数レンジに対して記号のエネルギーを表す一連の値を出力する。	换句话说，离散傅立叶变换器 503输出表示一系列频率范围的符号能量的一系列值。
中国語で言いたい事を正確に表すにはこの様な単語を上手く使える必要がありますね。	要想用中文正确地表达出自己想说的话，必须能流利地使用这样的词汇。
コングロマーチャントという言葉は、その独特な小売形態を表すために日本で生まれた。	复合零售这个词语是，用来形容那种独特的零售形态而在日本诞生的。
他の言葉で表すと、フォト4c、4d、4e及び関連付けられた説明3c、3d、3eを表すそれぞれの処理されたコンテンツ5c、5d、5eは、順次的に提示される。	换句话说，表示照片 4c、4d、4e以及它们关联的描述 3c、3d、3e的相应的经过处理的内容 5c、5d、5e被顺序地呈现。
肌代表色とは、入力画像内に存在する顔画像を代表する色を意味し、より具体的には、顔画像の肌部分の色を代表する色を意味する。	肌肤代表色是指代表输入图像内存在的脸图像的颜色，更具体而言，指代表脸图像的肌肤部分的颜色的颜色。
その唯一の目的は、後に示されるより詳細な記載に対する前置きとして、簡略化された形式で1または複数の実施形態のいくつかの概念を表すことである。	 其唯一目的是以简化形式来呈现一个或一个以上实施例的一些概念以作为稍后所呈现的更详细描述的序言。
その唯一の目的は、後に示されるより詳細な記載に対する前置きとして、簡略化された形式で1または複数の実施形態のいくつかの概念を表すことである。	 其唯一目的在于以简化形式呈现一个或一个以上实施例的一些概念以作为稍后呈现的更为详细的描述的序言。
次に、同じ番号が同じかまたは同様の要素を表す図面、および最初は図1を参照すると、システム／方法10は、ネットワークの多言語対話のためのオープン・アーキテクチャを含む。	现参看附图 (其中相似数字表示相同或类似组件 )并且最先参看图 1，系统 /方法 10包括用于网络的多语种互动的开放体系结构。
この唯一の目的は、後に示されるより詳細な説明への前置きとしての簡単な形式でここで開示されているいくつかの概念を表すことである。	 其唯一目的是以简化形式提供在此公开一些概念作为稍后提供的更详细描述的序言。
言い換えれば、式（4）はあらゆる置換画素に対して境界の後の第1の画素の画素値を使用することを表し、式（5）は置換画素値として画素値の重み付け和を使用することを表す。	 换句话说，等式 (4)表示将边界之后的第一像素的像素值用于每一替换像素，且等式 (5)表示将像素值的加权和用于替换像素值。
その唯一の目的は、後に示されるより詳細な記載に対する前置きとして、簡略化された形式で1または複数の態様のいくつかの概念を表すことである。	其唯一目的为以简化形式呈现一个或一个以上方面的一些概念，作为稍后呈现的更详细描述的序言。
その唯一の目的は、後に示されるより詳細な記載に対する前置きとして、簡略化された形式で1または複数の実施形態のいくつかの概念を表すことである。	其目的仅仅在于简单地描述一个或多个实施例的一些概念，以此作为后面的详细说明的序言。
その唯一の目的は、後に示されるより詳細な記載に対する前置きとして、簡略化された形式で1または複数の実施形態のいくつかの概念を表すことである。	其目的仅在于作为后文所提供的更详细描述的序言，以简化形式提供一个或多个实施例的一些构思。
技術的な観点から言えば、ソーシャルネットワークは、何らかの種類のデータ構造又はデータフォーマットで現実の社会的関係を表すものである。	从技术角度看，社交网络是真实社会关系以某种数据结构或数据格式的表示。
図1は、例えばユーザ101との対話が可能なゲーム端末又はTVセットといった家電デバイス、言い換えるとCEデバイスである電子デバイス102を有する分散処理システムを表す。	图 1绘出了一种分布式系统，其包括能够与用户 101交互的电子设备 102，例如消费电子设备（CE设备），如游戏机或电视机。
その唯一の目的は、後に示されるより詳細な記載に対する前置きとして、簡略化された形式で1または複数の実施形態のいくつかの概念を表すことである。	其目的仅在于作为后文所提供更详细描述的序言，以简化形式提供一个或多个实施例的一些概念。
その唯一の目的は、後に示されるより詳細な記載に対する前置きとして、簡略化された形式で1または複数の実施形態のいくつかの概念を表すことである。	其唯一目的是以简化的形式阐述一个或更多个实施例的一些概念，作为后面阐述的更详细的说明书的序言。
その唯一の目的は、後に示されるより詳細な記載に対する前置きとして、簡略化された形式で1または複数の実施形態のいくつかの概念を表すことである。	其唯一目的在于以简化形式呈现一个或一个以上实施例的一些概念以作为稍后呈现的更为详细的描述的序言。
その唯一の目的は、後に示されるより詳細な記載に対する前置きとして、簡略化された形式で1または複数の態様のいくつかの概念を表すことである。	其唯一的目的在于以简化形式提供了一个或多个方案的一些概念，作为稍后提供的更为详细的描述的序言。
その唯一の目的は、後に示されるより詳細な記載に対する前置きとして、簡略化された形式で1または複数の実施形態のいくつかの概念を表すことである。	其目的仅在于以简化形式提供一个或多个实施例的一些构思，作为后文所提供的更详细描述的序言。
その唯一の目的は、後に示されるより詳細な記載に対する前置きとして、簡略化された形式で1または複数の態様のいくつかの概念を表すことである。	其目的仅在于作为后文所提供更详细描述的序言，以简化形式提供一个或多个方面的一些概念。
たとえば、上記の説明全体にわたって言及されるデータ、命令、コマンド、情報、信号、ビット、シンボル、およびチップは、電圧、電流、電磁波、磁界または磁性粒子、光場または光学粒子、あるいはそれらの任意の組合せによって表すことができる。	举例来说，可由电压、电流、电磁波、磁场或磁粒子、光场或光粒子或其任何组合来表示可遍及上文描述而引用的数据、指令、命令、信息、信号、位、符号及码片。
例えば、上記の説明全体にわたって言及されるデータ、命令、コマンド、情報、信号、ビット、シンボル、及びチップは、電圧、電流、電磁波、磁界または磁性粒子、光場または光学粒子、あるいはそれらの任意の組合せによって表すことができる。	例如，在贯穿上面的描述中提及的数据、指令、命令、信息、信号、比特、符号和码片可以用电压、电流、电磁波、磁场或粒子、光场或粒子或者其任意组合来表示。
たとえば、上記の説明全体にわたって言及されるデータ、命令、コマンド、情報、信号などは、電圧、電流、電磁波、磁界または磁性粒子、光場または光粒子、あるいはそれらの任意の組合せによって表すことができる。	例如，可以用电压、电流、电磁波、磁场或磁性粒子、光场或光学粒子或它们的任意组合来表示贯穿于上面描述中提及的数据、指令、命令、信息、信号等。
すなわち、特定情報取得部72は、例えば、図26Bの選択画面に表示されたいずれかのアイコンが選択されたときにカメラが撮影した画像を、選択画面から選択されたアイコンが表す機器（以下、選択機器ともいう）の特定情報として取得する。	换言之，指定信息获取部分 72获取例如当选择图 26B的选择屏幕上显示的各图标中的任意一个时由相机拍摄的图像作为从选择屏幕中选择的图标所指示的设备 (在下文中，称为所选设备 )的指定信息。
彼はまとまった意味を表わす言葉を一言も言えない．	他连一句整话都说不出来。
私は自分の言いたいことを表わすのに適当な言葉が見つからない．	我找不到贴切的词儿来表达我的意思。
言葉が通じないので，手ぶりで意思を表わすほか仕方がない．	因为语言不通，只好用手势来表达心意。
我々は人が「死んだ」と言うのを忌んで，常により隠やかな言葉で敬虔な同情を表わす．	我们禁忌说人“死了”，总用比较温和的字眼儿来表示虔诚的同情。
（仏教の最高の礼；ひれ伏して頭を尊敬する人の足につけて礼をする→）（多く崇拝すべきでない事物に対し）ひれ伏して敬意を表わす，無条件に受け入れ崇拝する．	顶礼膜拜((成語))((貶し言葉))
Linda言語では、「テンプレート」と呼ばれる構成物(constructs)は、技術を整合することを介してタプルを関連づけられて取り組むために使用される。	在类 Linda语言中，称为“模板”的构造被用于经由匹配技术来相联地寻址元组。
処理回路はシングルキャリア送信に適合するようにしても良く、特に、離散的フーリエ変換・拡散・直交周波数分割多重（DFTS−OFDM）送信に適合するようにしても良い。	处理电路可适用于单载波传输，并且具体而言可适用于离散傅立叶变换扩频正交频分复用 (DFTS-OFDM)传输。
より具体的には、GERANは、基地局（AterおよびAbisインターフェース）と基地局コントローラ（Aインターフェースなど）とを接合するネットワークとともに、GSM／EDGEの無線部分である。	具体而言，GERAN是 GSM/EDGE以及连接基站 (Ater和 Abis接口 )与基站控制器 (A接口等等 )的网络的无线部分。
具体的には、各ONNU20宛て、並びにDBA周期2に適合するよう、該DBA情報1で得たONU20毎の送信許可データ量を分割して、一度の指示で送信許可する帯域（データ量）とタイミングを各ONU20毎のDBA情報2として決定する。	具体而言，将通过该 DBA信息 1得到的每个 ONU20的发送许可数据量分割为以各 ONU20为目的地、且适合于 DBA周期 2，然后将按照一次指示来发送许可的频带 (数据量 )和定时决定为每个 ONU20的 DBA信息 2。
特に、図6の駆動回路の機能は、入力信号603を出力605に選択的に結合し、これにより連結容量を「オン」して入力信号603を近傍線に容量結合することである（容量は図6に示さない）。	具体而言，图 6的驱动电路的功能为选择性地将输入信号 603耦合到输出 605并从而“开启”链接的电容器，以将输入信号603电容耦合到邻近线路 (所述电容器未在图 6中示出 )；
アルバイトすると言い出す。	说要打工。
無事に親に言い出すこともできたし。	也平安无事地向父母说出来了。
彼女は突然結婚すると言い出す。	她突然说要结婚。
この話はちょっと口に出すのがはばかられて，言いにくい．	这话有点儿碍口，不好说。
彼は性格がざっくばらんで，言いたいことがあればすぐそれを口に出す．	他性情率直，有话就说。
反対意見を出す．	提出异言
アルバイトすると言い出す。	说要打工。
春と言えば桜を思い出す。	提起春天就想到樱花。
その人は言葉を口に出さないが，一たび口に出すと要点を突く．	夫人不言，言必有中。
無事に親に言い出すこともできたし。	也平安无事地向父母说出来了。
彼女は突然結婚すると言い出す。	她突然说要结婚。
この話はちょっと口に出すのがはばかられて，言いにくい．	这话有点儿碍口，不好说。
（鉄の雄鶏—羽1本抜かない→）けちで出すのは舌もいや．	铁公鸡—一毛不拔((しゃれ言葉))
彼は喉に何かが詰まっているかのように，言葉を出すことができない．	他嘴里像有什么东西哽噎住，说不出话来。
商売すると金が物を言う，君はいったいどれくらいの金を出すんだ？	做买卖就是讲真格的，你到底拿出多少钱？
彼は性格がざっくばらんで，言いたいことがあればすぐそれを口に出す．	他性情率直，有话就说。
君は何によって彼がやったと言うのか？確実な証拠を出すことができるか？	你凭什么说是他干的？你拿得出可靠的实据吗？
人が君に少し意見を出すと，君は人が自分を攻撃すると言う，そんなばかな事があるものか！	人家给你提了一点意见，你就说人家攻击你，这是哪里的话？
（ロバにまたがって芝居の台本を読む→）結論を出すのはまだ早い，今に見ておれよ．	骑驴看唱本—走着瞧((しゃれ言葉))
ユーザは、ユーザの名前が「Steve Smith」である場合、ユーザに「1」を押下または言うように指示を出し、ユーザの名前がJohn Jonesである場合、ユーザに「2」を押下または言うように指示を出す等の、音声または記述された命令を受信できる。	用户可以接收可听或写下的指令，提示用户如果他的姓名是“Steve Smith”则按压或讲出“1”，提示用户如果他的姓名是“John Jones”则按压或讲出“2”。
一般的な見解として、x＝yならばKDF（x）はKDF（y）と同じ鍵を作り出すのは確かであるが、逆は常に成り立つとはかぎらない。	总而言之，尽管如果 x＝ y，则 KDF(x)肯定产生与 KDF(y)相同的密钥，但是反之则可能不一定成立。
トポロジ内の各装置では、ソース装置は、トポロジ発見処理の一部としてグローバル一意識別子を読み出す。	对于该布局中的每个设备而言，作为布局发现过程的一部分该源设备读取该全局唯一标识符。
私は彼に対してあやまろうと思ったが言葉に出すことができなかった，これは見えを張る気持ちを捨て切れなかったからかもしれない．	我想向他检讨又张不开口，这也许是放不下架子。
旧社会では，私ども客にサービスする仕事の人間は（声を出す勇気があっただろうか→）文句一つ言えなかった．	旧社会里，咱侍候人的敢吱声吗？
なお、図1の構成では、各画素からの信号電荷又は積分信号電荷を垂直CCD、水平CCDを用いて読み出していたが、例えばこれをCMOSスイッチを用いて読み出すことも可能である。	另外，就图 1的结构而言，虽然将来自各个像素的信号电荷或积分信号电荷用垂直 CCD、水平 CCD读出，但是例如也能够将其用 CMOS开关读出。
例えば、3Pサーバ218に格納されているこの情報は、簡単なHTML（ハイパーテキストマークアップ言語）ファイルとして読み出されるとしてよい。 尚、HTMLファイルは通常、ファイヤーウォール216を介して読み出すことが容認されている情報である。	例如，3P服务器 218存储的此信息可作为简单的 HTML(超文本标记语言 )文件来读取，该文件通常是通过防火墙 216读取的可接受信息。
また、スライド式携帯端末100の開状態において、第2筐体130の後端側は、第1筐体110の後端部（具体的には後端側壁部110a）から後方に張り出す位置、つまりオーバーハングした位置に配置され、後側背面部146は外部に露出した状態となる。	另外，在滑动式移动终端 100的打开状态下，第 2壳体 130的后端侧配置在从第 1壳体 110的后端部 (具体而言是后端侧壁部 110a)向后方伸出的位置，即，悬垂的位置，后面背面部 146为露出外部的状态。
特に、この第1アンテナスイッチ10Aは、第1λ／4信号伝送路18aを構成要素の1つとした方向性結合器36を有することから、送信信号の出力時に、アンテナで反射が生じた場合、方向性結合器36の反射波出力端子40から反射波に比例した信号を取り出すことができ、反射波を検出することが可能となる。	具体而言，第一天线开关 10A具有定向耦合器 36，该定向耦合器 36把第一λ/4信号传输线 18a作为其部件。 因而，当输出传输信号在天线处被反射时，与反射波成比例的信号可以在定向耦合器 36的反射波输出端子 40处被读出，以便可以检测反射波。
AGCH108またはRGCH110のチャネル品質が、あらかじめ定められた期間にわたりあらかじめ定められた閾値を下回る場合、WTRU102は、速度要求およびスケジューリング手続きが失敗したことを認識して、RLを回復するための手続きを呼び出すRL障害を宣言する。	如果 AGCH 108或 RGCH 110上的信道质量在预定时段中低于预定阈值，那么 WTRU 102将会认定该速率请求和调度过程已失败，并且将会宣告 RL故障，所述 RL故障则会调用一用于恢复 RL的过程。
WTRU102がHICH112でACKを（好ましくは複数回数または指定された期間にわたり）受信できない場合、WTRU102は、ULデータ伝送およびH−ARQ手続きが失敗したことを認識して、RLを回復するための手続きを呼び出すRL障害を宣言する。	如果 WTRU 102未能在 HICH 112上接收到 ACK(优选是多次接收或是经过了规定时段 )，那么 WTRU 102将认定 UL数据传输和 H-ARQ过程已失败，并且将宣告 R L故障，所述故障则会调用一用于恢复 RL的过程。
WTRU102の測定ユニット206は、HS−PDSCH604のチャネル品質を監視し、HS−PDSCH604のチャネル品質が、あらかじめ定められた期間にわたりあらかじめ定められた閾値を下回ったままである場合、WTRU102は、RL障害を宣言して、RLを回復するための手続きを呼び出すことができる。	WTRU 102的测量单元 206将会监视 HS-PDSCH 604的信道质量，如果 HS-PDSCH 604的信道质量在预定时段中保持在预定阈值以下，那么WTRU102可以宣告 RL故障并调用一用于恢复 RL的过程。
WTRU102が、速度要求402を（好ましくは複数回数または指定された期間にわたり）送信した後にスケジューリング割り当て406またはH−ARQフィードバック404を受信しない場合、WTRU102は、速度要求およびスケジューリング手続きが失敗したことを認識して、接続を回復するための手続きを呼び出す無線リンク障害を宣言する。	如果 WTRU 102在发送了速率请求 402(优选是发送了多次请求或是经过了规定的时段 )之后没有接收到任何调度分配 406或 HARQ反馈 404，那么 WTRU 102将会认定该速率请求和调度过程已失败，并且将会宣告无线电链路故障，所述故障则会调用一用于恢复连接的过程。
言い終わると原稿をそでに入れて出て行った．	说罢就袖着稿子走了。
仕事で大衆の言い分を聞き入れないとつまずいて失敗しやすい．	工作中听不进群众意见就容易摔跟头。
床に就いて休んでいるよう医者から言い含められているのに，彼はどうしても聞き入れようとしない．	医生嘱咐他卧床休息，可他硬是不听。
ちょうちんと言い、紙でできた手さげランプです。今はもう使いませんが、昔はロウソクを中に入れ、夜は持って歩きました。	是叫做灯笼的用纸手工制成的灯。虽然现在已经不使用了，但是很久以前会在里面放上蜡烛，晚上走路的时候提着它。
諫言を聞き入れる．	纳谏
あなたの発言は4番めに入れる．	你的发言列在第四。
忠言を聞き入れる，忠告に従う．	听从忠言
彼の言葉を受け入れなよ。	不要采纳他的话。
くわ入れ作業の前に降る恵みの雨．	锄头雨((方言))
彼は誰の言葉も聞き入れない．	他谁的话也听不进。
オリーブやカンランを入れたお茶．	元宝茶((方言))
この子はおとなしく言ったら聞き入れない，きつく言ったら，泣きだす．	这孩子说轻了他不听，说重了，他就哭。
この子はおとなしく言ったら聞き入れない，強く言ったらすぐ泣きだす．	这孩子说轻了他不听，说重了，他就哭。
彼は門番に誰も中に入れないように言った。	他告诉门卫谁都不要放进来。
私がどう言っても，彼は聞き入れない．	我怎么说，他也不依。
言葉選びに力を入れねばならない．	要在措辞上多下些功夫。
コーチは「1番入れ，3番退場」と言った．	教练说：“一号上，三号下”。
言い終わると原稿をそでに入れて出て行った．	说罢就袖着稿子走了。
告げ口をする，悪口を言う，入れ知恵をささやく．	告枕头状
どのような人を選んで指導グループに入れるかは，大衆に発言権がある．	选配什么人进领导班子，群众有发言权。
気管支鏡を入れるのはつらい経験だと言う人もいる。	也有人说将支气管镜插入喉腔是个痛苦的经历。
仕事で大衆の言い分を聞き入れないとつまずいて失敗しやすい．	工作中听不进群众意见就容易摔跟头。
まだ足りねーって言うなら、 あとどれだけ好きならお前は俺を受け入れる？	既然说还不够，那还要多喜欢你才能接受我呢？
原稿は，彼らに言及したところは，すべて赤い棒線が入れられ，削除された．	稿子，凡是涉及他们的地方，都给打上红杠子，刪掉了。
床に就いて休んでいるよう医者から言い含められているのに，彼はどうしても聞き入れようとしない．	医生嘱咐他卧床休息，可他硬是不听。
具体的には、OLT10でDBA情報1を下り信号フレームのPLOAMに入れ、複数m個の下り信号フレーム（S302−1〜m）を用いて通知する。	具体而言，由 OLT10将 DBA信息 1插入至下行信号帧的 POLAM，并使用多个 m个的下行信号帧 (S302-1～ m)进行通知。
ちょうちんと言い、紙でできた手さげランプです。今はもう使いませんが、昔はロウソクを中に入れ、夜は持って歩きました。	是叫做灯笼的用纸手工制成的灯。虽然现在已经不使用了，但是很久以前会在里面放上蜡烛，晚上走路的时候提着它。
あなたにこんなにお褒めにあずかりましたが，（このようなお言葉をどうして受け入れられるでしょうか→）誠に恐れ入ります．	您这样夸奖我，我怎么敢当呢？
人様は正しいことを言っているのに，君はそれを受け入れない，それはあまりにも愚かでかたくななきらいがある．	人家说得对，你也不肯接受，未免太愚顽啦。
（塩漬けにした臭い魚を商う店→）悪人どもの集まる場所．（‘如入鲍鱼之肆，久而不闻其臭。’（悪人の集まる場所に入ればいつの間にか悪に染まる）という言葉があり，また同じ意味のことを‘入鲍忘臭’とも言う．）	鲍鱼之肆((成語))
（仏教の最高の礼；ひれ伏して頭を尊敬する人の足につけて礼をする→）（多く崇拝すべきでない事物に対し）ひれ伏して敬意を表わす，無条件に受け入れ崇拝する．	顶礼膜拜((成語))((貶し言葉))
そのようなサンプルアンドホールド式のシステムにおいて、ディスプレイの順次的なリフレッシュ期間中に、異なる画像、具体的には、3D表示用の交互に入れ替わる左用画像と右用画像を表示するには、例えば、左眼用光源が右眼用のデータの表示中にはオンとならず、逆もまた同様となるように、バックライト光源の綿密な順序付けが要求される。	在这种采样保持系统中，在显示器的顺序刷新周期期间显示不同的图像，特别是对 3D显示而言，显示交替的左图像和右图像，需要对背光源仔细排序，以使得例如在显示用于右眼的数据期间左眼光源不打开，反之亦然。
しかしながら、情報セット間のそれらの様々な遷移的変化が再現描写メディア中に入れられるにつれて、それらが視聴者にとってあまりにも明白となってそれにより視聴者の体験から気をそらすことにならないことを確かなものとするように、適応がなされなければならないことが予期される。	然而，当信息组之间的这些各种过渡变化被输入代表性媒体中时，期望进行适应以确保它们对观看者而言不变得太明显，从而从观看者的体验中转移。
犯罪の証拠を捏造して，彼は反革命分子であると言い立てて陥れる．	捏造罪证，诬陷他是反革命。
諫言を聞き入れる．	纳谏
あなたの発言は4番めに入れる．	你的发言列在第四。
忠言を聞き入れる，忠告に従う．	听从忠言
気管支鏡を入れるのはつらい経験だと言う人もいる。	也有人说将支气管镜插入喉腔是个痛苦的经历。
どのような人を選んで指導グループに入れるかは，大衆に発言権がある．	选配什么人进领导班子，群众有发言权。
まだ足りねーって言うなら、 あとどれだけ好きならお前は俺を受け入れる？	既然说还不够，那还要多喜欢你才能接受我呢？
いいえ！	不价！
いいえ、行きません。	不，不去。
いいえ、違います。	不，不是。
いいえ違います。	不，不是的。
いいえ、大丈夫。	没关系。
いいえ、ちがいます。	不，不是。
いいえ、まだです。	不，我还差得远。
いいえちがいます。	不是的。
いいえ、僕はしてません。	不，我没在做。
はい、それともいいえ？	是还是不是？
いいえ、英語で書きます。	不，我用英语写。
いいえ、初めてです。	不，是第一次。
家に居たい。	我想在家。
貧しい家．	贫苦人家
新しい家．	新房子
いいえ、飲んだことがありません。	不，没喝过。
いいえ私は日本語が分かりません。	不，我不会日语。
彼はそっけなく『いいえ』と答えた。	他冷淡地回答了“不是”。
いいえ、あなたは働きすぎです。	不，你工作得过头了。
いいえ。あなたの方が可愛いです。	不，你更可爱。
いいえ、あまり好きではありません。	不，不怎么喜欢。
「たばこは吸いますか」「いいえ」	“你吸烟么” “不吸”
いいえ、それを洗ってはいけません。	不，你不可以洗那个。
いいえ、私はそれを持っていません。	不，我没有那个。
いいえ、これから書きます。	不，我现在开始写。
いいえ、テレビを見ていました。	不，我看了电视。
いいえ、犬の散歩をしました。	不，我带狗散了步。
いいえ、山登りをしました。	不，我爬了山。
いいえと言っているじゃないですか。	难道不是在说不吗？
いいえ，私はそうは言わなかった．	不对，我没有那么说。
あれは北京大学ですか？—いいえ．	那是北京大学吗？—不是。
ありがとう！—いいえ，どういたしまして．	谢谢你！—不谢不谢。
自動車を1台雇えたか？—いいえ．	雇着了一辆汽车吗？—没雇着。
言えなくもない。	也不是不能说。
家に帰りたい。	想回家。
家に帰れない。	回不了家。
家柄が低い．	家世寒门
家柄が卑しい．	家世寒微
家では使っていない。	在家没有使用。
家で本を読みたい。	想在家看书。
家に帰りたくない。	不想回家。
家に来て欲しくない。	我不想让你来我家。
家にはだれもいない。	谁也不在家
家に帰りたくない。	我不想回家。
家にきてきださい。	请来家里。
古い家を取り壊した．	把旧房子拆了。
広々して明るい家．	很敞亮的房子
生活の苦しい家．	困难的户头
家貧しく志を得ない．	家贫落泊
家もなければ職もない．	没家没业
前置きを二言三言言っただけで，すぐさま問題の中心に入った．	前言只用三言两语，很快进入焦点。
いわゆる非識字者を一掃するということが，何億かの農民を置き去りにするなら，空言になるのではないか，間違いなく空言になってしまう．	所谓扫除文盲，如果离开了几亿农民，岂非成了空话？
唯一の目的は、後述するより詳細な説明の前置きとして、1つまたは複数の態様のいくつかの概念を簡略な形で提示することである。	其唯一目的是以简化形式呈现一个或一个以上方面的某些概念以作为稍后呈现的更详细描述的序言。
その唯一の目的は、後に示されるより詳細な記載に対する前置きとして、簡略化された形式で1または複数の実施形態のいくつかの概念を表すことである。	 其唯一目的是以简化形式来呈现一个或一个以上实施例的一些概念以作为稍后所呈现的更详细描述的序言。
その唯一の目的は、後に示されるより詳細な記載に対する前置きとして、簡略化された形式で1または複数の実施形態のいくつかの概念を表すことである。	 其唯一目的在于以简化形式呈现一个或一个以上实施例的一些概念以作为稍后呈现的更为详细的描述的序言。
この唯一の目的は、後に示されるより詳細な説明への前置きとしての簡単な形式でここで開示されているいくつかの概念を表すことである。	 其唯一目的是以简化形式提供在此公开一些概念作为稍后提供的更详细描述的序言。
その唯一の目的は、後に示されるより詳細な記載に対する前置きとして、簡略化された形式で1または複数の態様のいくつかの概念を表すことである。	其唯一目的为以简化形式呈现一个或一个以上方面的一些概念，作为稍后呈现的更详细描述的序言。
その目的は、後で提示されるより詳細な説明に対する前置きとして、述べる特徴のいくつかの概念を簡略化された形態で提示することである。	其目的为以简化形式呈现所描述特征的一些概念以作为稍后呈现的更详细描述的序言。
その唯一の目的は、後に示されるより詳細な記載に対する前置きとして、簡略化された形式で1または複数の実施形態のいくつかの概念を表すことである。	其目的仅仅在于简单地描述一个或多个实施例的一些概念，以此作为后面的详细说明的序言。
その唯一の目的は、後に示されるより詳細な記載に対する前置きとして、簡略化された形式で1または複数の実施形態のいくつかの概念を表すことである。	其目的仅在于作为后文所提供的更详细描述的序言，以简化形式提供一个或多个实施例的一些构思。
この要約の唯一の目的は、後で提示される、より詳細な説明に対する前置きとして簡略化した形態で開示される態様の一部の概念を提示することである。	此概述的唯一目的是以简化形式呈现所揭示方面的一些概念，作为稍后呈现的更详细描述的序言。
その唯一の目的は、後に示されるより詳細な記載に対する前置きとして、簡略化された形式で1または複数の実施形態のいくつかの概念を表すことである。	其目的仅在于作为后文所提供更详细描述的序言，以简化形式提供一个或多个实施例的一些概念。
その唯一の目的は、後に示されるより詳細な記載に対する前置きとして、簡略化された形式で1または複数の実施形態のいくつかの概念を表すことである。	其唯一目的是以简化的形式阐述一个或更多个实施例的一些概念，作为后面阐述的更详细的说明书的序言。
その唯一の目的は、後に示されるより詳細な記載に対する前置きとして、簡略化された形式で1または複数の実施形態のいくつかの概念を表すことである。	其唯一目的在于以简化形式呈现一个或一个以上实施例的一些概念以作为稍后呈现的更为详细的描述的序言。
本要約は、以下に示す詳細な説明の前置きとして、その基本的な理解をもたらすために、簡略化された形式で技術主題の態様を示す。	作为下文将呈现的详细描述的前言，本发明内容以简化形式讨论主题的各个方面，从而提供对主题的基本理解。
その唯一の目的は、後に提示される、より詳細な記述への前置きとして、開示される態様のいくつかのコンセプトを簡易な形で提示することである。	其唯一目的在于以简化形式呈现所揭示的方面的一些概念以作为稍后呈现的更详细描述的序言。
その唯一の目的は、後に示されるより詳細な記載に対する前置きとして、簡略化された形式で1または複数の態様のいくつかの概念を表すことである。	其唯一的目的在于以简化形式提供了一个或多个方案的一些概念，作为稍后提供的更为详细的描述的序言。
その唯一の目的は、後に示されるより詳細な記載に対する前置きとして、簡略化された形式で1または複数の実施形態のいくつかの概念を表すことである。	其目的仅在于以简化形式提供一个或多个实施例的一些构思，作为后文所提供的更详细描述的序言。
その唯一の目的は、後に示されるより詳細な記載に対する前置きとして、簡略化された形式で1または複数の態様のいくつかの概念を表すことである。	其目的仅在于作为后文所提供更详细描述的序言，以简化形式提供一个或多个方面的一些概念。
その唯一の目的は、後で提示されるより詳細な説明の前置きとして1つまたは複数の態様のいくつかの概念を単純化した形で提示することである。	其唯一目的是以简化的形式将一个或一个以上方面的一些概念作为对稍后呈现的较详细的描述的序言而呈现。
言い換えれば、デバイス74のユーザが、グループ通信UI142をウィンドウディスプレイの最前面に置くのに時間をかけていれば、グループ通信UI142を介してユーザは更に、閾値期間（例えば2秒以内、5秒以内、…など）内にグループ通信セッションの開始の要求を選択する可能性が高いだろう。	换言之，如果设备 74的用户花费时间将群通信 UI 142放置在窗口显示的最前端，那么用户很有可能在阈值时段内 (例如，2秒内、5秒内、等等 )进一步经由群通信 UI 142来选择发起群通信会话的请求。
君，馬丁に，早く鞍を置くように言ってください．	你告诉马夫，叫他赶快鞴鞍子。
他人の言を多く聞き疑わしい問題はしばらく差し置く．	多闻阙疑
2人の婦人を妻としその2人を共に正妻の地位に置く．	两头大((清末から中華人民共和国成立以前のいわゆる旧社会の言葉))((慣用語))
言い換えれば、デバイス74のユーザが、グループ通信UI142をウィンドウディスプレイの最前面に置くのに時間をかけていれば、グループ通信UI142を介してユーザは更に、閾値期間（例えば2秒以内、5秒以内、…など）内にグループ通信セッションの開始の要求を選択する可能性が高いだろう。	换言之，如果设备 74的用户花费时间将群通信 UI 142放置在窗口显示的最前端，那么用户很有可能在阈值时段内 (例如，2秒内、5秒内、等等 )进一步经由群通信 UI 142来选择发起群通信会话的请求。
言い換えれば、ユーザ108の待ち時間を減らすため、クライアントデバイス104が連絡先の番号を検索する必要がないように、サーバは、ダイアルする番号をクライアントデバイス104に送ることができる。	换句话说，为了减少用户 108的等待时间，服务器可以向客户端设备 104发送要拨打的号码，使得客户端设备104不必查找联系人的号码。
言い換えると、リスト134は、曖昧値128a〜128fのどれも関連する動作の暗黙的な起動を引き起こすほどには高くない場合に、クライアントデバイス104に送ることができる。	换句话说，如果歧义值 128a-d都不高得足以引起相关联的动作的隐含调用，则列表 134可以被发送到客户端设备 104。
言い換えれば、ユーザ108の待ち時間を減らすため、クライアントデバイス104が連絡先の番号を検索する必要がないように、サーバは、ダイアルする番号をクライアントデバイス104に送ることができる。	换句话说，为了减少用户 108的等待时间，服务器可以向客户端设备 104发送要拨打的号码，使得客户端设备104不必查找联系人的号码。
言い換えると、リスト134は、曖昧値128a〜128fのどれも関連する動作の暗黙的な起動を引き起こすほどには高くない場合に、クライアントデバイス104に送ることができる。	换句话说，如果歧义值 128a-d都不高得足以引起相关联的动作的隐含调用，则列表 134可以被发送到客户端设备 104。
彼にお祝いの言葉を送る。	我向他发送了祝福的话语。
私に彼の履歴書を送ると言っていました。	你说了给我发送他的履历书。
今日送ると言ったけど、今日中に準備ができないので、明日送ります。	说了今天送，但是今天没有办法准备完，所以明天送。
いくつかの実施では、サーバ116は、ウィンドウ136を表示するためのコード(例えばHTML(ハイパーテキストマークアップ言語)コード)を生成し、リスト134と併せてそのコードを送る。	在一些实施方式中，服务器 116产生用于显示窗口 136的代码 (例如，HTML(超文本标记语言 )代码 )，并且将该代码与列表 134相结合地发送。
（より大きなレンジを有するために）マクロブロックのQPが全く異なる場合、より多くのビットが使用されマクロブロックに対する差分QP＿MBを信号で送る。	如果宏块 QP是非常不同的 (就具有较大的范围而言 )，那么可使用更多的比特来发信号表示用于宏块的差异QP_MB。
言い換えれば、ユーザ108の待ち時間を減らすため、クライアントデバイス104が連絡先の番号を検索する必要がないように、サーバは、ダイアルする番号をクライアントデバイス104に送ることができる。	换句话说，为了减少用户 108的等待时间，服务器可以向客户端设备 104发送要拨打的号码，使得客户端设备104不必查找联系人的号码。
言い換えると、リスト134は、曖昧値128a〜128fのどれも関連する動作の暗黙的な起動を引き起こすほどには高くない場合に、クライアントデバイス104に送ることができる。	换句话说，如果歧义值 128a-d都不高得足以引起相关联的动作的隐含调用，则列表 134可以被发送到客户端设备 104。
他のブルートゥースデバイス15からデータを受信するために、受信機30は、アンテナ20によって受信された信号を処理（限定ではなく説明のために、増幅、周波数ダウンコンバート、またはフィルタ処理）し、得られた信号をモデムプロセッサ35に送ることができる。	为了从其它蓝牙设备 15接收数据，接收机 30可以处理 (举例而言但非限制地，放大、下变频或滤波 )由天线 20接收的信号，并将生成的信号发送给调制解调处理器 35。
年貢を納める，地租を納める．≒完钱粮((清末から中華人民共和国成立以前のいわゆる旧社会の言葉))	完粮纳税
年貢を納める，地租を納める．≒完钱粮((清末から中華人民共和国成立以前のいわゆる旧社会の言葉))	完粮纳税
ショウジョウソウ．	猩猩草
10000ウォン	10000韩元
ヒョウ．	金钱豹
ビサウ．	比绍
「グウーグウグウーグウ」とまた眠った．	“呼—呼呼—呼”又睡了。
ウラル．	乌拉尔’
経営ノウハウ	经营技术知识
ウイキョウ油．	茴香油
（鳥）ブッポウソウ．	三宝鸟
エンドウゾウムシ．	豌豆象
コウウチョウはほかの鳥の巣に卵を産む。	（コ
ウルグアイラウンド．	乌拉圭回合
イネヨトウガ，オオメイチュウ．	大螟
小さいブドウ	小葡萄
今しがた庭にショウジョウコウカンチョウがいた。	刚才院子里有一只北美红雀。
ウェブ化	网络化
ウザイけど。	你好吵啊。
アナウンサー．	报告员
クロヒョウ．	黑豹
ビンロウ樹．	槟榔树
アナウンサー．	播送员
アナウンサー．	播音员
ブドウ一房．	一串葡萄
ダーウィン．	达尔文’
ウリのへた．	瓜当
ドナウ川．	多瑙河
『ファウスト』	《浮士德》
アナウンサー．	广播员
ヘリウム灯．	氦灯
ハリウッド．	好莱坞
チョウ結び．	蝴蝶结
ウォール街．	华尔’街
ロープウェー．	架空索道
クウェート．	科威特
トウモロコシ．	老玉米
濃縮ウラン．	浓缩铀
ノルウェー．	挪威
コールプラウ．	刨煤机
干しブドウ．	葡萄干［儿］
ブドウ酒．	葡萄酒
ブドウ状奇胎．	葡萄胎
ブドウ棚．	葡萄架
ブドウ園．	葡萄园
ブドウのつる．	葡萄藤
つりウインチ．	起重绞车
ウインチ．	牵引机
牽引プラウ．	牵引犁
ウジがわいた．	生了蛆。
スウェーデン．	瑞典
ウガンダ．	乌干达
物理的暴力がヴァイオレンスであるのは紛れもない事実である。	物理性暴力是暴力，这是不争的事实。
変顔のヴァリエーションは星の数ほどあります。	鬼脸的种类就像星星那么多。
様々な修正（modification）、変更、およびヴァリエーションが、特許請求の範囲から逸脱することなく、上に記述された装置および方法の詳細、オペレーション、および配置において行われることができる。	可在以上所述的方法和装置的布置、操作和细节上作出各种修改、变更和变型而不会背离权利要求的范围。
電力線通信に用いられるププラグインモジュールは、スマート（Smart）らの米国特許出願公開2002／0039388「高データ転送率の電力線ネットワークシステムおよび方法」、ヴァルベック（Walbeck）らの米国特許出願公開2002／0060617「モジュラー電力線ネットワークアダプタ」、およびシェッファー（Schaeffer）らの米国特許出願公開2003／0062990「電力線ブリッジ装置」に記載されている。	在 Smart等人题为‘High data-rate powerline network system and method’的美国专利申请 2002/0039388，Walbeck等人题为‘Modular power line network adaptor’美国专利申请2002/0060617以及 Schaeffer，JR等人题为‘Powerline bridge apparatus’的美国专利申请 2003/0062990中描述了用于电源线通信使用的这种插入模块。
ヴァン・ダイク．	凡戴克
ヴァン・ゴッホ．	凡高
ヴィクトリア．	维多利亚
ダ・ヴィンチ．	达芬奇
ヴィーナス．	维纳斯
ルーヴル美術館でミロのヴィーナスを見にフランスへ行くための貯金をしている。	为了去法国卢浮宫美术馆看米洛的维纳斯，我正在存钱。
ヴィーナス．	维纳斯
ルーヴル美術館でミロのヴィーナスを見にフランスへ行くための貯金をしている。	为了去法国卢浮宫美术馆看米洛的维纳斯，我正在存钱。
ヴェニス，ヴェネツィア．	威尼斯
『ヴェニスの商人』の中のシャイロックは典型的な吸血鬼である．	《威尼斯商人》中的夏洛克是一个典型的吸血鬼。
『ヴェニスの商人』の中のシャイロックは典型的な吸血鬼である．	《威尼斯商人》中的夏洛克是一个典型的吸血鬼。
ヴェニス，ヴェネツィア．	威尼斯
図3を参照すると、たとえば、ヴォイス・オーバ・インターネット・プロトコル（VoIP）電話通信を使用するなど、情報がネットワークを介してストリーミングされるストリーミング・モードについての例示的実施形態に関して、さらに詳細に説明される。	参看图 3，描述流式传输模式的例示性实施例的进一步细节，其中信息例如通过使用因特网话音协议 (VoIP)电话通信而经由网络被流式传输。
ウラジヴォストーク．	符拉迪沃斯托克
ウラジヴォストーク．	海参崴
ウラジヴォストーク．	海参崴
ラテン化新文字，北方方言音を標準とした中国語ローマ字．（1931年にウラジヴォストークで開かれた中国新文字第1次代表大会で瞿秋白・呉玉章により制定され，1933年以降上海や解放区で用いられた．）≒北拉((略語))，新文字((略語))．	拉丁化新文字
ヴォルガ川．	伏尔加’河
ヴォルガ川．	伏尔加’河
ヴォルテール．	伏尔泰’
ヴォルテール．	福禄特尔’
一般に、ウィザード形式での設定に慣れてくると、ウィザード形式での設定完了までの時間は短くなる傾向を示す。	一般而言，所示出的趋势是：
M＝ウィザード形式での全設定画面S中の位置（何番目の画面）	M＝向导形式的全部设定画面 S中的位置 (第几个画面 )
図6は、ワークフローをウィザード形式で表示した際の流れの一例を示す説明図である。	图 6是表示以向导方式显示工作流时的流程的一例的说明图。
まず、図6を用いて、ワークフローでのウィザード表示形式を説明する。	首先，使用图 6来说明工作流的向导显示方式。
通常表示キーK3が押下されると、液晶表示部は、ウィザード形式による表示をやめる。	当通常显示键 K3被按下时，液晶显示部停止基于向导形式的显示。
ウィザード形式での設定では、設定完了まで一定の時間を要する。	在向导形式的设定中，直到设定完成为止需要一定的时间。
そして、表示制御部10はカウントした時間をウィザード形式に含まれる画面数で除す。	然后，显示控制部 10将计时所得的时间除以向导形式中包含的画面数。
その後、管理UI（301）は、ユーザから必要な構成情報を引き出すために必要なウィザード画面を決定する（604）。	管理 UI(301)然后确定必要的向导屏幕以从用户处获取必要的配置信息(604)。
例えば、ユーザーは、符号化ウィザードのようなユーザーインタフェースを介し、高度のレート歪み効率が所望されていることを示す。	例如，用户通过诸如编码向导的用户界面指示需要高度的速率失真效率。
図6は、本発明の第1の実施形態に係るワークフローをウィザード形式で表示した際の流れの一例を示す説明図である。	图 6是表示本发明第一实施方式中以向导形式显示工作流程时的流程的一个例子的说明图。
ウィザード形式での各設定画面Sで設定に要した時間の影響を受けつつ、再開信号RSが発せられることになる。	此外，会在受到向导形式下的各设定画面 S上进行设定所需的时间的影响下，发出重启信号 RS。
そして、（式1）の演算での、ウィザード形式の1画面における所要時間T2（式1におけるA）は固定された値を用いていた。	(式 1)的运算当中的、向导形式的 1画面中的所需时间 T2(式 1中的 A)使用了固定的值。
表示制御部10は、ウィザード形式による設定の開始から、終了までの時間をカウントする。	显示控制部 10对从向导形式的设定开始到结束为止的时间进行计时。
例えば、使用者は、表示形式決定画面W5で、メニュー形式キーK24（メニュー表示形式）、ショートカット方式キーK25（一覧表示形式）、ウィザード形式キーK26（ウィザード表示形式）の何れかのキーを押下する。	例如，使用者在显示方式确定画面W5中，按下菜单方式按键K24(菜单显示方式)、快捷方式按键 K25(一览显示方式 )、向导方式按键 K26(向导显示方式 )中的任一按键。
従って、ウィザード形式の各設定画面Sで実際に要した時間を考慮して再開信号RSが発せられるので、ウィザード形式での設定完了によりジョブが開始される時点と、定着部7が印刷可能温度に到達する時点を精度よく近づけることができる。	因此，由于考虑了向导形式的各设定画面 S上实际所需的时间来发送重启信号 RS，因此能够高精度地使由于向导形式下的设定完成而开始任务的时间点和定影部 7到达能够印刷温度的时间点相靠近。
例えば、省電力モードからの復帰の際に、ウィザード形式の設定画面Sを表示する設定であれば、表示制御部10は、ログイン後、ウィザード形式での設定完了の旨の入力（一覧画面の実行開始キーK5の押下やスタートキー14の押下等）があるまでの時間を計時する。	例如，当从省电模式回归时，如果是显示向导形式的设定画面 S的设定，则显示控制部 10对登录后直到具有意为向导形式的设定完成的输入 (一览画面的执行开始键 K5的按下或开始键 14的押下等 )为止的时间进行计时。
即ち、入力部（タッチパネル部12等）は、使用者を特定する入力を受け付け、制御部（表示制御部10）は、ウィザード形式による設定開始から設定完了までに要する時間を把握し、把握した時間をウィザード形式での設定画面S数で除した値を求め、求めた値を記憶部（メモリ19、記憶装置92）に使用者ごとの所要時間データとして記憶させる。	即，输入部 (触摸面板部 12等 )接受确定使用者的输入，控制部 (显示控制部 10)把握从向导形式的设定开始到设定完成为止所需的时间，并求出将所把握时间除以向导形式的设定画面 S的数目所得的值，将求出的值作为每个使用者的所需时间数据存储到存储部 (存储器 19、存储装置 92)中。
尚、ワークフローを呼び出した際、設定のための画面の表示形式としては、ウィザード表示形式、メニュー表示形式、一覧表示形式が用意される。	另外，调用工作流时，作为用于设定的画面的显示方式，备有向导显示方式、菜单显示方式、一览显示方式。
例えば、図6は、コピーに関するワークフローであり、図5における「資料作成」のワークフローを呼び出した際のウィザード形式でのワークフローの一例を示している。	例如，图 6～图 9是与复印有关的工作流，表示调用图 5中“资料制作”工作流时的向导方式的工作流的一例。
図8の例では、ウィザード形式で、最初の設定画面Sから設定一覧D1まで、10画面を有するワークフローが呼び出された例を示している。	在图 10的例子中，以向导形式示出了从最初的设定画面 S到设定一览 D1，具有 10个画面的工作流程被调出的例子。
これにより、ウィザード形式での設定画面のうち、最終画面を表示している時に、定着部7の温度を印刷可能温度に到達させることができ、電力の無駄がない（図8の例では、第10画面）。	由此，在向导形式的设定画面中，在显示最终画面时，能够使定影部 7的温度到达能够印刷温度，电力不会浪费 (在图 10的例子中，第十画面 )。
このように、定着温度制御の開始を遅らせ、定着部7の温度は、ウィザード形式での設定完了の時点にあわせ印刷可能温度とされる。	如此，通过延迟开始定影温度控制，定影部 7的温度可与向导形式的设定完成的时间点相匹配地成为能够印刷温度。
具体的には、図8に示すように、第7画面からウィザード形式での設定終了時点までの時間T3で消費される電力を節約できる。	具体来说，如图 10所示，能够节约从第七画面到向导形式的设定结束时间点为止的时间 T3内所消耗的电力。
次に、表示制御部10は、省電力モードからの復帰の際、ワークフローを呼び出してウィザード形式での表示を行う設定であるかを確認する（ステップ♯2）。	接着，显示控制部 10确认是否为如下设定： 当从省电模式回归时，调出工作流程而进行向导形式的显示 (步骤 #2)。
尚、ウィザード形式の各設定画面で、通常表示キーK3が押下された場合も、表示制御部10は直ちに再開信号RSを発してもよい。	此外，在向导形式的各设定画面中，即使通常显示键 K3(参照图 6、图 7)被按下的情况下，显示控制部 10也可以立即发出重启信号 RS。
次に、表示制御部10は、ウィザード形式の設定での1画面の設定に要する時間の目安を示す所要時間データを用いて、次の演算が満たされるかを確認する（ステップ♯9）。	接着，显示控制部 10使用表示向导形式的设定中 1个画面的设定所需的时间的目标的所需时间数据，来确认是否满足下面的运算 (步骤 #9)。
一方、X、A、Wについては同じで、W＝10（ウィザード形式の全表示画面）であり、M＝5の時（現在の表示画面が第5番目の画面）、W−（M＋1）＝4となり、（式1）を満たす（ステップ♯9のYes）。	另一方面，当 X、A、W相同，W＝ 10(向导形式的全部显示画面 )，M＝ 5时 (当前的显示画面为第五个画面 )，W-(M+1)＝ 4，满足 (式 1)(步骤 #9的“是”)。
もし、（式1）を満たす場合（ステップ♯9のYes）、ウィザード形式での設定完了までに定着部7が印刷可能温度に至るように、ステップ♯3に移行し、表示制御部10は、再開信号RSを発する。	如果满足 (式 1)(步骤 #9的“是”)，为使得定影部 7在向导形式的设定完成之前达到能够印刷温度，转到步骤 #3，且显示控制部 10发出重启信号 RS。
即ち、制御部（表示制御部10）は、ウィザード形式での設定画面Sが切り替えられるごとに再開信号RSを発するか否かを定める（判断する）。	即，控制部 (显示控制部 10)在每当向导形式下的设定画面 S被切换时确定 (判断 )是否发出重启信号 RS。
例えば、定着温度制御を再開する前のウィザード形式での設定画面Sでの設定が、長くなった場合、制御部（表示制御部10）からの再開信号RSの発信が遅れる。	例如，当重启定影温度控制之前向导形式下的设定画面 S上的设定变长时，来自控制部 (显示控制部 10)的重启信号 RS的发送延迟。
例えば、表示制御部10は、ウィザード形式以外の表示形式で表示する場合であるとして、通常モードへの復帰とともに、本体制御部9にむけて、再開信号RSを発する。	例如，显示控制部 10视为以向导形式以外的显示形式进行显示，向通常模式回归，并向主体控制部 9发出重启信号 RS。
即ち、入力部（タッチパネル部12等）は、定着温度制御を再開するとき、ウィザード形式以外の表示形式で設定画面Sを表示する旨の入力を受け付け、制御部（表示制御部10）は、定着温度制御の停止状態から定着温度制御を再開する際、ウィザード形式以外の表示形式で表示する場合、通常モードへの復帰とともに再開信号RSを発する。	即，在重启定影温度控制时，输入部 (触摸面板部 12等 )接受意为以向导形式以外的显示形式显示设定画面 S的输入，在从定影温度控制的停止状态重启定影温度控制时，当以向导形式以外的显示形式进行显示的情况下，控制部 (显示控制部 10)与向通常模式回归的同时发出重启信号 RS。
より具体的に、本実施形態では、制御部（表示制御部10）は、ウィザード形式での最初から現在表示している画面までの設定画面S数に1を加えた値をウィザード形式における全設定画面S数から減じた値が、求められた安定必要時間T1を所要時間データで定められた所要時間T2で除した値より小さくなったとき、再開信号RSを発する。	更为具体地说，在本实施方式中，控制部 (显示控制部 10)给从向导形式下的最初画面到当前显示的画面为止的设定画面 S数加 1，将加得的值从向导形式下的全部设定画面 S数中减去，当减得的值比将求出的稳定所需时间 T1除以由所需时间数据确定的所需时间 T2而得的值小时，发出重启信号 RS。
このようにして、第3の実施形態の発明によれば、ウィザード形式による設定開始から設定完了までに要する時間が把握され、把握した時間をウィザード形式での設定画面S数で除した値を求め、求めた値が記憶部（メモリ19、記憶装置92）に使用者ごとの所要時間データとして記憶される。 使用者により設定の習熟度や習熟速度は異なるところ、各使用者にあわせて、定着部7での定着温度制御の再開時点を容易に定めることができる。	根据第三实施方式的发明，尽管由于使用者不同而导致设定的熟练度或熟练速度不同，但能够容易地与各使用者相适应而确定定影部 7的定影温度控制的重启时间点。
【図6】本発明の一実施形態における、CTRL−ALT−F1キーの同時押下による、プレOS遠隔PCアシストウィザードユーザインタフェースに入る方法をエンドユーザに示すためのメッセージを表示する起動スクリーンを示す画面の一例を示す。	图 6是示例性屏幕快照，其示出了根据本发明实施例的启动屏幕，其具有向终端用户指示如何通过同时按下 CTRL-ALT-F1键来进入预 OS远程 PC协助向导用户界面的消息。
一方、省電力モードからの復帰の際、ワークフローを呼び出してウィザード形式での表示を行う設定であれば（ステップ♯2のYes）、表示制御部10は、温度センサ74の出力（電圧）に基づき、定着部7（加熱ローラ72）の温度を把握する（ステップ♯7）。	另一方面，当从省电模式回归时，如果是调出工作流程而以向导形式进行显示的设定 (步骤 #2的“是”)，则显示控制部 10根据温度传感器 74的输出 (电压 )，来把握定影部 7(加热辊 72)的温度 (步骤 #7)。
従って、所要時間データを使用者にあわせることにより、省電力モードからの復帰の際、ウィザード形式での設定完了時点と、定着部7の印刷可能温度への到達時点を近づけやすくすることができる。	如果习惯了向导形式的设定，则到向导形式的设定完成为止的时间变短。 因此，通过使所需时间数据与使用者相适应，当从省电模式回归时，能够容易使得向导形式的设定完成时间点和定影部 7到达能够印刷温度的时间点相靠近。
実施形態の中には、コントローラーが、符号化セッションウィザードインターフェースからの入力、別のエンコーダーアプリケーションインターフェースからの入力、又は別のソースからの入力を受信し、特定のルールを使用し符号化される特定のコンテンツを有するように映像を指定するものもある。	在某些实施例中，控制器也可以从编码会话向导接口、从另一编码器应用程序接口或从另一源接收输入，以指示视频具有要实用特定的规则编码的特定内容。
そこで、本実施形態の複合機100では、ワークフローのウィザード形式での設定完了が完了すると予測される予測時点TP1から、定着部7の温度を印刷可能温度として安定状態とするのに要する時間（安定必要時間T1）分遡った時点TP2（第1時点に相当）を目安として、定着温度制御が開始される。	因此，在本实施方式的数码复合机 100中，以从预测为完成工作流程以向导形式的设定的预测时间点 TP1、追溯定影部 7的温度成为能够印刷温度而变为稳定状态所需的时间 (稳定所需时间 T1)的时间点 TP2(相当于第一时间点 )为目标，开始定影温度控制。
もし、省電力モードからの復帰の際、液晶表示部11にウィザード形式の設定画面Sを表示させるのでなければ（ステップ♯2のNo）、直ちにジョブ開始指示がなされることもあり得るので、表示制御部10は、本体制御部9にむけて、定着部7での定着温度制御を再開させるための再開信号RSを発信する（ステップ♯3）。	如果不是在从省电模式回归时使液晶显示部 11显示向导形式的设定画面 S(步骤 #2的“否”)，由于也可立即进行任务开始指示，因此显示控制部10向主体控制部 9发送用于重启定影部 7中的定影温度控制的重启信号 RS(步骤 #3)。
そこで、制御部（表示制御部10）は、定着温度制御の停止状態から定着温度制御を再開する際、ウィザード形式以外の表示形式で表示する場合、通常モードへの復帰とともに再開信号RSを発する。 これにより、通常モードへの復帰の際、定着部7での定着温度制御が速やかに再開され、画像形成装置（例えば、複合機100）はできるだけ早く印刷可能な状態となる。	因此，在以向导形式以外的显示形式进行显示时，与向通常模式回归的同时，立即重启定影部 7上的定影温度控制。
定着温度制御を開始してから、定着部7が印刷可能温度に到達するまで、季節や設置環境（空調の設定温度等）等の要因によって変化するところ、これにより、実際の印刷可能温度に到達するまでの時間にあわせて、安定必要時間T1が求められる。 従って、ウィザード形式での設定完了によりジョブが開始される時点と、定着部7が印刷可能温度に到達する時点を精度よく近づけることができる。	根据第二实施方式的发明，从开始定影温度控制到定影部 7达到能够印刷温度为止的时间，会随着季节或设置环境 (空调的设定温度等 )等要因而变化，但能够将由于向导形式的设定完成而开始任务时间点与定影部 7达到能够印刷温度时间点高精度地靠近。
即ち、本発明の画像形成装置（例えば、複合機100）は、画像形成装置に関する設定入力を行うための入力部（タッチパネル部12等）と、予め定められた複数の機能の設定画面Sを対話型で順次表示するウィザード形式で表示する表示部（液晶表示部11）を含む操作部（操作パネル1）と、入力部になされた設定入力を認識する制御部（表示制御部10）と、用紙へのトナーの定着を行うためにヒータ71を内蔵する定着部7であって、温度をトナー像の定着に必要な温度である印刷可能温度で維持する定着温度制御を行うとともに、入力部への入力がないまま予め定められた時間が経過したこと、入力部に省電力モードに移行する旨の指示がなされたことのいずれか、又は、両方を条件として、省電力モードに移行し、定着温度制御を停止する定着部7と、定着部7の温度を検知するための温度検知体（温度センサ74）と、現在の定着部7の温度から定着温度制御を行った際、印刷可能温度に至るまでの時間である安定必要時間T1を定めるための安定必要時間データと、ウィザード形式での設定画面Sの1画面あたりの設定に要する所要時間T2を定めるための所要時間データを、少なくとも記憶する記憶部（メモリ19、記憶装置92）と、を有し、入力部への入力があったため、及び／又は、画像形成装置に対する操作がなされたことを操作検知部（開閉検知センサ87等の各種センサ）が検知したため、省電力モードから通常モードに復帰して、定着温度制御の停止状態から、定着温度制御を再開するとき、制御部は、温度検知体の出力に基づく現在の定着部7の温度と、安定必要時間データに基づき安定必要時間T1を求め、所要時間データとウィザード形式で設定を行うべき設定画面Sの残数に基づき、設定が完了すると予測される予測時点TP1から安定必要時間T1分遡った時点である第1時点と、第1時点から所要時間T2分前の時点である第2時点の間に定着温度制御を再開させる旨の再開信号RSを発し、定着部7は、再開信号RSが発せられた後、定着温度制御を再開する。	以及存储部 (存储器 19、存储装置 92)，至少存储有稳定所需时间数据和所需时间数据，其中所述稳定所需时间数据用于确定在根据当前的定影部 7的温度进行定影温度控制时，达到能够印刷温度为止的时间、即稳定所需时间 T1，所述所需时间数据用于确定向导形式下的设定画面 S每一个画面的设定所需要的所需时间 T2； 由于输入部上有输入、和 /或操作检测部 (开闭检测传感器 87等各种传感器 )检测到有对图像形成装置的操作，从省电模式向通常模式回归，当从定影温度控制的停止状态重启定影温度控制时，控制部根据基于温度检测体的输出的当前的定影部 7的温度、和稳定所需时间数据求出稳定所需时间 T1，将从根据所需时间数据和应以向导形式进行设定的设定画面 S的剩余数预测为设定完成的预测时间点 TP1追溯稳定所需时间 T1的量的时间点设为第一时间点，将从第一时间点向前所需时间 T2的量的时间点设为第二时间点，在第一时间点和第二时间点之间发出意为重启定影温度控制的重启信号 RS，定影部 7在发出了重启信号 RS后，重启定影温度控制。
続いて、ウィジェット情報取得部133は、ウィジェット情報取得用URL宛に、ウィジェット情報の取得要求を送信する（S124）。	接下来，小程序信息获取单元 133向小程序信息 URL发送请求用于获取小程序信息 (S124)。
ウィジェットIDは、各ウィジェット21を一意に識別する識別情報である。	小程序 ID是用于唯一识别每个小程序 21的识别信息。
スキャンウィジェット21a、印刷ウィジェット21b、及び翻訳コピーウィジェット21cは、本実施の形態において、ウィジェット21として総称されるアプリケーションプログラムである。	扫描小程序 21a、打印小程序 21b以及翻译和复印配置 21c是应用程序并且在该实施例中被统一称为小程序 21。
スキャンウィジェット21a、印刷ウィジェット21b、及び翻訳コピーウィジェット21cは、本実施の形態において、ウィジェット21として総称されるアプリケーションプログラムである。	在本实施例中，扫描小程序 21A、打印小程序 21B和翻译复印小程序 21C是可以被共同称为小程序 21的应用程序。
当該ユーザIDに対応するウィジェット情報管理テーブル227が存在しない場合、ウィジェット情報登録部223は、当該ユーザIDに対応するウィジェット情報管理テーブル227を生成し、生成されたウィジェット情報管理テーブル227にウィジェット情報を登録する。	如果没有找到与用户 ID对应的小程序信息管理表 227，小程序信息注册单元 223为用户 ID生成小程序信息管理表 227并在生成的表 227中注册小程序信息。
当該ユーザIDに対応するウィジェット情報管理テーブル227が存在しない場合、ウィジェット情報登録部223は、当該ユーザIDに対応するウィジェット情報管理テーブル227を生成し、生成されたウィジェット情報管理テーブル227にウィジェット情報を登録する。	当不存在与用户 ID相对应的小程序信息管理表 227时，小程序信息注册单元 223生成与用户 ID相对应的小程序信息管理表 227，并且在生成的小程序信息管理表 227中注册小程序信息。
換言すれば、ウィジェットマネージャ22と協調して動作するアプリケーションが、本実施の形態におけるウィジェット21である。	换句话说，该实施例的小程序 21是与小程序管理器 22合作操作的应用程序。
ウィジェット情報にはウィジェット21の実行に必要な情報（例えば、処理フローに関する情報）が含まれる。	小程序信息 (处理信息 )包括执行小程序 21必需的信息 (例如关于处理流的信息 )。
すなわち、各ウィジェット21は、当該ウィジェット21がインストールされたユーザ端末20のユーザに関連付けられている。	因而，小程序 21与安装了小程序 21的用户终端 20的用户(用户ID)相关联。
ウィジェットアドレスは、ネットワーク通信において各ウィジェット21を一意に識別するための識別情報（例えば、URL等）である。	小程序地址是用于在网络通信中唯一地识别翻译和复印小程序21c的识别信息 (例如 URL)。
また、ウィジェット情報管理テーブル227は、ウィジェットマネージャ22の終了時に削除される。	还假设当小程序管理器 22被终止时删除小程序信息管理表 227。
印刷ウィジェット21bは、ユーザ端末20内に保存されている文書データの印刷を画像形成装置10に実行させるウィジェット21である。	打印小程序 21B使得图像形成设备 10打印出在用户终端 20中保存的文档数据。
換言すれば、ウィジェットマネージャ22と協調して動作するアプリケーションが、本実施の形態におけるウィジェット21である。	这就是说，根据本实施例的小程序 21是与小程序管理器 22协同操作的应用。
ウィジェット情報にはウィジェット21の実行に必要な情報（例えば、処理フローに関する情報）が含まれる。	小程序信息包括执行小程序 21所必须的信息 (例如，与处理流相关的信息 )。
すなわち、各ウィジェット21は、当該ウィジェット21がインストールされたユーザ端末20のユーザに関連付けられている。	这就是说，小程序 21与安装了小程序 21的用户终端 20的用户相关联。
ウィジェットアドレスは、ネットワーク通信において各ウィジェット21を一意に識別するための識別情報（例えば、URL等）である。	小程序地址是用于在网络通信中唯一地识别每个小程序 21的识别信息 (例如 URL)。
【図13】ウィジェット選択画面の表示例を示す図である。	图 13是示出示例小程序选择屏幕的图；
ウィジェット情報取得部133は、ユーザ管理テーブル141に登録されているユーザの中から実行対象として選択されたユーザに属するウィジェット21のウィジェット情報をウィジェットマネージャ22より取得する。	小程序信息获取单元 133从小程序管理器 22中获取属于从用户管理表 141中注册的用户 (用户 ID)中选择的用户 (用户 ID)的所选小程序 21的小程序信息。
図13は、ウィジェット選択画面の表示例を示す図である。	图 13是说明示例小程序选择屏幕 620的图。
ウィジェット情報取得部133は、ユーザ管理テーブル141に登録されているユーザの中から実行対象として選択されたユーザに属するウィジェット21のウィジェット情報をウィジェットマネージャ22より取得する。	小程序信息获取单元 133从小程序管理器 22获取属于被选为用户管理表 141中注册的用户之中的执行目标的用户的小程序 21的小程序信息。
ユーザIDは、翻訳コピーウィジェット21cのユーザの識別子である。	用户 ID是翻译复印小程序 21C的用户的识别符。
ウィジェット情報管理テーブル227には、ユーザ端末20において起動されている各ウィジェット21のウィジェット情報が登録されるテーブルであり、ユーザ端末20の記憶装置に生成される。	小程序信息管理表 227存储在用户终端 20上运行的小程序 21的小程序信息，并且在用户终端 20的存储区域中生成。
ウィジェット情報提供部225は、画像形成装置10からの要求に応じ、ウィジェット情報管理テーブル227に登録されているウィジェット情報を画像形成装置10に提供（送信）する。	响应于来自图像形成装置10的请求，小程序信息提供单元225向图像形成装置10提供 (发送 )在小程序信息管理表 227中注册的小程序信息。
ウィジェット情報提供部225は、画像形成装置10からの要求に応じ、ウィジェット情報管理テーブル227に登録されているウィジェット情報を画像形成装置10に提供（送信）する。	小程序信息提供单元225响应于来自图像形成设备10的请求，向图像形成设备10提供 (发送 )在小程序信息管理表 227中注册的小程序信息。
同図では、翻訳コピーウィジェット21cに対応するボタン621と、スキャンウィジェット21aに対応するボタン622と、印刷ウィジェット21bに対応するボタン623とが表示されている。	在图 11中，显示与翻译复印小程序 21C相对应的按钮 621、与扫描小程序 21A相对应的按钮 622以及与打印小程序 21B相对应的按钮623。
具体的には、ユーザ端末20内における或るウィジェット21の起動に応じてユーザAに関して広告が発行された後、当該ユーザ端末20内において、他のウィジェット21が起動されたとしても当該ウィジェット情報に応じた広告は発行されない。	即，在响应于用户终端 20的小程序 21的激活而发布用于用户 A的广告后，即使激活相同用户终端 20的另一个小程序 21也不发布广告。
具体的には、ユーザ端末20内における或るウィジェット21の起動に応じてユーザAに関して広告が発行された後、当該ユーザ端末20内において、他のウィジェット21が起動されたとしても当該ウィジェット情報に応じた広告は発行されない。	详细地，假设响应于在用户终端 20中的某个小程序的激活而发布了与用户 A相关的公告，当在相同的用户终端 20中激活另一个随后的小程序 21时，不发布与这样的小程序信息相关的公告。
【図7】ウィジェット起動時の処理手順を説明するためのシーケンス図である。	图 7是示出当激活小程序时执行的处理的序列图；
サービス制御部138は、ウィジェット21から要求されたサービスの実行を制御する。	服务控制单元 138控制由小程序 21请求的服务的执行。
図7は、ウィジェット起動時の処理手順を説明するためのシーケンス図である。	图 7是示出当激活小程序时执行的处理的序列图。
表示名は、翻訳コピーウィジェット21cの名前の表示用の文字列である。	显示名称是将被显示以代表翻译和复印小程序 21c的字符串。
ところで、ウィジェット情報は、属性情報管理ファイル215より取得されるものである。	小程序信息从属性信息管理文件 215中获取。
ステップS125では、同図に示されるようなウィジェット情報の一覧が送信される。	在步骤 S125，发送图 12所示的小程序信息组。
表示名は、翻訳コピーウィジェット21cの名前の表示用の文字列である。	显示名称是用于显示翻译复印小程序 21C的名称的字符串。
ところで、ウィジェット情報は、属性情報管理ファイル215より取得されるものである。	从属性信息管理文件 215中获取小程序信息。
したがって、本実施の形態では、ユーザ端末20の起動後において初めてウィジェット21が起動された場合、ウィジェット情報管理テーブル227が生成される。	相应地，在该实施例中，当在打开用户终端 20后首次激活小程序 21时，生成小程序信息管理表 227。
ボタンの押下に応じ、ウィジェット情報取得部133は、選択されたボタンに対応するユーザIDに関連付けられているウィジェット情報取得用URLをユーザ管理テーブル141より取得する。	当按下按钮时，小程序信息获取单元 133从用户管理表 141检索对应于与按下的按钮相关联的用户 ID的小程序信息 URL。
ここでいう不正ウィジェットとは、例えば、悪意のあるWebサービスの提供者等によって開発され、ネットワーク上でダウンロード可能とされているウィジェット21等を想定するとよい。	这里，“未授权小程序”指示例如由恶意网络服务提供商开发的并且能够从网络上下载的小程序 21。
したがって、本実施の形態では、ユーザ端末20の起動後において初めてウィジェット21が起動された場合、ウィジェット情報管理テーブル227が生成される。	由此，在本实施例中，当激活用户终端20之后第一次激活小程序21时，生成小程序信息管理表227。
ボタンの押下に応じ、ウィジェット情報取得部133は、選択されたボタンに対応するユーザIDに関連付けられているウィジェット情報取得用URLをユーザ管理テーブル141より取得する。	当按下按钮时，小程序信息获取单元 133从用户管理表 141获取小程序信息，该小程序信息能够获取与对应于选定的按钮的用户 ID相关联的 URL。
スキャン翻訳ウィジェットの最終成果物は、翻訳済データであるため、第一の実施の形態の場合、スキャン翻訳ウィジェットは、ステップS141（図12）において当該最終成果物を得ることができる。	由此，在第一实施例的情况下，扫描翻译小程序可以在步骤 S141中获得最终产品 (见图 12)。
ウィジェット21が最終成果物に対応する画像データの提供を要求するか否かは、例えば、図21に示されるようにウィジェット情報において指定可能としてもよい。	关于小程序 21是否请求与最终产品相对应的图像数据，在图 21所示的小程序信息中可以指定。
ところで、本実施の形態では、画像形成装置10において最初にサービスが実行される（スキャンが実行される）ウィジェット21（翻訳コピーウィジェット21c）を用いて説明を行った。	本实施例描述了在图像形成设备 10中执行第一业务 (执行扫描 )的小程序 21(翻译复印小程序 21C)。
したがって、図2における提示ユニット230およびスマートウィジェット240は、それぞれ、図1における提示ユニット130およびスマートウィジェット140に対応する。	因此，图 2中的显示单元 230和智能窗口小部件 240分别对应于图 1中的显示单元 130和智能窗口小部件 140。
【図10】実行対象とするウィジェットの選択処理の処理手順を説明するためのシーケンス図である。	图 10是示出选择将被执行的小程序的处理的序列图；
属性情報管理ファイル215は、ウィジェット21対する設定情報等を格納するファイルである。	属性信息管理文件 215包含用于小程序 21的配置信息 (小程序信息 )。
同図に示されるように、ユーザ管理テーブル141は、ユーザIDとウィジェット情報取得用URLとを対応づけて管理する。	如图 9所示，用户管理表 141将用户 ID与小程序信息 URL相关联地存储。
図7の処理の後、ユーザは、翻訳コピーウィジェット21cを動作させるために画像形成装置10の設置場所へ移動する。	在图 7的处理之后，用户移动到安装了图像形成装置 10的位置来执行翻译和复印小程序 21c。
図10は、実行対象とするウィジェットの選択処理の処理手順を説明するためのシーケンス図である。	图 10是示出选择将被执行的小程序的处理的序列图。
したがって、ステップS125において送信されるウィジェット情報は、例えば、図12に示されるような構成を有する。	例如，将在步骤 S125发送的每组小程序信息具有如图 12所示的配置。
ウィジェットアドレスは、ネットワーク通信において各ウィジェット21を一意に識別するための識別情報（例えば、URL等）である。	小程序地址是用于在网络通信中唯一地识别翻译和复印小程序21c的识别信息 (例如 URL)。
ウィジェットアドレスは、ネットワーク通信において各ウィジェット21を一意に識別するための識別情報（例えば、URL等）である。	小程序地址是用于在网络通信中唯一地识别每个小程序 21的识别信息 (例如 URL)。
換言すれば、ウィジェットマネージャ22と協調して動作するアプリケーションが、本実施の形態におけるウィジェット21である。	换句话说，该实施例的小程序 21是与小程序管理器 22合作操作的应用程序。
また、ウィジェット情報管理テーブル227は、ウィジェットマネージャ22の終了時に削除される。	还假设当小程序管理器 22被终止时删除小程序信息管理表 227。
換言すれば、ウィジェットマネージャ22と協調して動作するアプリケーションが、本実施の形態におけるウィジェット21である。	这就是说，根据本实施例的小程序 21是与小程序管理器 22协同操作的应用。
ウィジェット情報取得部133は、ユーザ管理テーブル141に登録されているユーザの中から実行対象として選択されたユーザに属するウィジェット21のウィジェット情報をウィジェットマネージャ22より取得する。	小程序信息获取单元 133从小程序管理器 22中获取属于从用户管理表 141中注册的用户 (用户 ID)中选择的用户 (用户 ID)的所选小程序 21的小程序信息。
ウィジェット情報取得部133は、ユーザ管理テーブル141に登録されているユーザの中から実行対象として選択されたユーザに属するウィジェット21のウィジェット情報をウィジェットマネージャ22より取得する。	小程序信息获取单元 133从小程序管理器 22获取属于被选为用户管理表 141中注册的用户之中的执行目标的用户的小程序 21的小程序信息。
ウィスコンシン．	威斯康辛
ウィリアム・ジェームズ．	威廉詹姆斯
ウィリアムさんは医者にはなれない。	威廉姆不能成为医生。
TSO（前HMSO）は、現在は私企業であり、ウィリアムリーグループに属している。	TSO（前HMSO）现在是一家私企，所属于威廉姆斯李集团。
ウィリアム・ジェームズ．	威廉詹姆斯
研究者はインフルエンザウィルスを研究した。	研究人员研究了流感病毒。
彼はそのウィルスの形態形成を分析した。	他分析了那个病毒的 形态发生。
彼らはそのウィルスの危険性を誇張している。	他们夸大了那种病毒的危险性。
この過程によってある種のウィルスを不活性にすることができる。	通过这个过程可以使某种病毒失去活性。
あるレトロウィルスがその病気の原因とされてきた。	某种逆转录病毒被认为是引起那种病的原因。
私はサイトメガロウィルスからワクチンを開発するために研究している。	我正在研究如何从巨细胞病毒中提取疫苗。
局所電力管理システム1の外部から電力管理装置11が受ける攻撃としては、例えば、DoS攻撃（Denial of Service attack）やコンピュータウィルス等が考えられる。	可以想到 DoS攻击 (拒绝服务攻击 )、计算机病毒等为电力管理装置 11从本地电力管理系统 1的外部受到的攻击。
図9に示すように、システム管理部1125は、電力管理装置11の基本的な動作を制御するためのプログラムであるファームウェアのバージョン管理、アップデート、アクセス制限、ウィルス対策等を行う。	如图 9所示，例如，系统管理单元 1125执行固件 (其是控制电力管理装置 11的基本操作的程序 )版本的管理 /更新，限制到其上的访问，以及采取防病毒措施。
局所電力管理システム1の外部から電力管理装置11が受ける攻撃としては、例えば、DoS攻撃（Denial of Service attack）やコンピュータウィルス等が考えられる。	作为电力管理设备 11从局部电力管理系统 1的外部受到的攻击，可以设想的是DoS攻击 (拒绝服务攻击 )、计算机病毒等。
図9に示すように、システム管理部1125は、電力管理装置11の基本的な動作を制御するためのプログラムであるファームウェアのバージョン管理、アップデート、アクセス制限、ウィルス対策等を行う。	如图 9中所示，系统管理单元 1125进行例如，固件 (它是用于控制电力管理设备11的基本操作的程序 )的版本的管理 /更新，限制对所述固件的访问，和采取防病毒措施。
また、例えば、家などの社外に持ち出して使用していたPC100を社内に持ち込んで使用した場合には、社外でインターネットEなどのネットワークを介してPC100にウィルスが感染し、会社に出勤した後にPC100が社内のイントラネットRなどに接続される可能性もある。	另外，例如，在将被带回并在办公室外诸如家中使用的 PC100带到办公室并在办公室内使用 PC100的情形中，PC100可在办公室外经由诸如因特网 E的网络被感染病毒，并且，PC100在达到工作后，可被连接到公司内的内部网 R等等。
また、例えば、家などの社外に持ち出して使用していたPC100を社内に持ち込んで使用した場合には、社外でインターネットEなどのネットワークを介してPC100にウィルスが感染し、会社に出勤した後にPC100が社内のイントラネットRなどに接続される可能性もある。	另外，例如，在将被带回并在办公室外诸如家中使用的 PC100带到办公室并在办公室内使用 PC100的情形中，PC100可在办公室外经由诸如因特网 E的网络被感染病毒，并且，PC100在达到工作后，可被连接到公司内的内部网 R等等。
研究者はインフルエンザウィルスを研究した。	研究人员研究了流感病毒。
彼はそのウィルスの形態形成を分析した。	他分析了那个病毒的 形态发生。
彼らはそのウィルスの危険性を誇張している。	他们夸大了那种病毒的危险性。
あるレトロウィルスがその病気の原因とされてきた。	某种逆转录病毒被认为是引起那种病的原因。
この過程によってある種のウィルスを不活性にすることができる。	通过这个过程可以使某种病毒失去活性。
私はサイトメガロウィルスからワクチンを開発するために研究している。	我正在研究如何从巨细胞病毒中提取疫苗。
局所電力管理システム1の外部から電力管理装置11が受ける攻撃としては、例えば、DoS攻撃（Denial of Service attack）やコンピュータウィルス等が考えられる。	可以想到 DoS攻击 (拒绝服务攻击 )、计算机病毒等为电力管理装置 11从本地电力管理系统 1的外部受到的攻击。
図9に示すように、システム管理部1125は、電力管理装置11の基本的な動作を制御するためのプログラムであるファームウェアのバージョン管理、アップデート、アクセス制限、ウィルス対策等を行う。	如图 9所示，例如，系统管理单元 1125执行固件 (其是控制电力管理装置 11的基本操作的程序 )版本的管理 /更新，限制到其上的访问，以及采取防病毒措施。
局所電力管理システム1の外部から電力管理装置11が受ける攻撃としては、例えば、DoS攻撃（Denial of Service attack）やコンピュータウィルス等が考えられる。	作为电力管理设备 11从局部电力管理系统 1的外部受到的攻击，可以设想的是DoS攻击 (拒绝服务攻击 )、计算机病毒等。
図9に示すように、システム管理部1125は、電力管理装置11の基本的な動作を制御するためのプログラムであるファームウェアのバージョン管理、アップデート、アクセス制限、ウィルス対策等を行う。	如图 9中所示，系统管理单元 1125进行例如，固件 (它是用于控制电力管理设备11的基本操作的程序 )的版本的管理 /更新，限制对所述固件的访问，和采取防病毒措施。
また、例えば、家などの社外に持ち出して使用していたPC100を社内に持ち込んで使用した場合には、社外でインターネットEなどのネットワークを介してPC100にウィルスが感染し、会社に出勤した後にPC100が社内のイントラネットRなどに接続される可能性もある。	另外，例如，在将被带回并在办公室外诸如家中使用的 PC100带到办公室并在办公室内使用 PC100的情形中，PC100可在办公室外经由诸如因特网 E的网络被感染病毒，并且，PC100在达到工作后，可被连接到公司内的内部网 R等等。
ダーウィン．	达尔文’
ダーウィン氏．	达尔文氏
巻き胴ウィンチ．	滚筒绞车
スウィングドア．	弹簧门
ガラス窓，ショーウィンドー．	玻璃窗
進化論，ダーウィン主義．	达尔文主义
彼は優秀なウィング選手だ。	他是优秀的侧翼球员。
左折のウィンカーを出した。	打开了左转灯。
ハロウィンのデコレーション	万圣节的装饰
ダーウィンの進化論（学説）．	达尔文的进化论学说
本変更例では、複数のウィンドウは、6個のウィンドウ201〜206からなる。	在本变更例中，多个窗口由 6个窗口 201～ 206组成。
ウィンドウW2は、ウィンドウ702の上端と下端で1の値に近づき、ウィンドウ702の中心にゼロ値を有する。	窗口 W2在窗口 702的高端和低端达到统一值，并且在窗口 702的中心具有零值。
なお、メインウィンドウ100およびサブウィンドウ102〜106のサイズおよび配置、サブウィンドウの個数については、図3の態様に限定されるものではない。	再有，主窗口 100及子窗口 102～ 106的尺寸及配置、子窗口的个数不限于图 3的状态。
【図9】ウィンドウの対応する周波数応答を示す、図5のウィンドウのグラフである。	图 9是图 5的窗口的曲线图，其示出了所述窗口的相应频率响应。
【図10】ウィンドウの対応する周波数応答を示す、図7のウィンドウのグラフである。	图 10是图 7的窗口的曲线图，其示出了所述窗口的相应频率响应。
【図19】TCPスライディング・ウィンドウ動作を描いた図である。	图 19示出了 TCP滑动窗口操作。
上記の説明に選択されたウィンドウ502及び702はそれぞれ、Hannウィンドウ及び逆Hannウィンドウと似ているが、他のウィンドウ形状が使用されてもよい。	尽管为以上说明选择的窗口 502、702分别类似于 Hann窗口和反转 Hann窗口，但也可以使用其它窗口形状。
リーク電流＋（RX電流＊（ウィンドウ／間隔）） （1）	漏电 _电流 +(RX_电流 *(窗口 /间隔 ))(1)
タスクバーを他のウィンドウの前面に表示する	在其他窗口前面显示任务栏
ベドウィンのテントはヤギの毛でできている。	贝都因人的帳篷是用羊毛做的
ベドウィンは何世紀も砂漠で暮らしてきた。	贝都因人幾個世紀以来都住在沙漠中
ウィンプルの被り方を教えてください。	请教我包头巾的方法。
その企業はウィンドジャマーを復元した。	那家企业将帆船复原了。
私は朝食によくウィンナーソーセージを食べる。	我早餐经常吃维也纳香肠。
暗い道でショーウィンドーが明るく光っていた。	昏暗的路上，商店橱窗发出明亮的光。
たとえば、図11と図12に示されたように、2つの非対称的なウィンドウ1102及び1202が選択されてもよく、第1のウィンドウ1102は、ウィンドウ処理空間の上側半分を占め、第2のウィンドウ1202は、ウィンドウ処理空間の下側半分を占める。	例如，如图 11和图 12所示，可以选择两个非对称窗口 1102、1202，其中，第一窗口 1102占据加窗空间的上一半，而第二窗口 1202占据加窗空间的下一半。
たとえば、W1に図5に示されたウィンドウ502が選択された場合は、W2に図7のウィンドウ702が選択されてもよい。	例如，如果对 W1选择了图 5中所示的窗口 502，则可以对 W2选择图 7所示的窗口 702。
本明細書ではウィンドウ形状の特定の例を説明したが、他のウィンドウ形状が使用されてもよい。	尽管本文描述了窗口形状的特定示例，但也可以使用其它窗口形状。
図2に戻ると、ウィンドウ処理（ブロック204A及び204B）が完了した後で、被ウィンドウ処理音声ブロックがそれぞれ変換される（ブロック206A及び206B）。	返回到图 2，在完成加窗 (框 204A和 204B)之后，分别对加窗后音频块进行变换(框 206A和 206B)。
これらウィンドウ監視マネージャ13A及びウィンドウ制御マネージャ13Bは、クライアント装置20と直接通信する機能を保持している。	这些窗口监视管理器 13A以及窗口控制管理器 13B保持着与客户机装置 20直接通信的功能。
即ち、ウィンドウ新規表示を示す制御用データを受信した場合には、ウィンドウID、名前、領域を受信する（ステップS205）。	也就是说，在接收到表示窗口重新显示的控制用数据的情况下，接收窗口 ID、名称、区域 (步骤 S205)。
即ち、項目「ウィンドウID」に受信したウィンドウIDを登録し、項目「名前」に受信した名前を登録する。	也就是说，在项目“窗口 ID”中登记接收到的窗口 ID，在项目“名称”中登记接收到的名称。
一方、受信した制御用データがウィンドウ消去を示すものである時には、ウィンドウID、名前、領域を受信する（ステップS208）。	另一方面，在接收到的控制用数据表示窗口消除时，接收窗口 ID(步骤 S208)。
そして、ウィンドウ制御テーブル24Aから、その受信したウィンドウIDで示される行を削除する（ステップS209）。	然后，从窗口控制表 24A删除由该接收到的窗口 ID所表示的行 (步骤 S209)。
また、ウィンドウ属性変更を示す制御用データを受信した場合には、ウィンドウIDと名前を受信する（ステップS210）。	此外，在接收到表示窗口属性变更的控制用数据的情况下，接收窗口 ID和名称(步骤 S210)。
そして、ウィンドウ制御テーブル24Aのその受信したウィンドウIDで示される行の「名前」に、受信した名前を登録し直す（ステップS211）。	然后，在窗口控制表 24A的由该接收到的窗口 ID所表示的行的“名称”中，重新登记接收到的名称 (步骤 S211)。
そして、ウィンドウ制御テーブル24Aのその受信したウィンドウIDで示される行の「キャプチャフラグ」が「1」かどうかを判別する（ステップS215）。	然后，判别窗口控制表 24A的由该接收到的窗口 ID所表示的行的“捕获标记”是否为“1”(步骤 S215)。
そして、再度、ウィンドウ制御テーブル24Aの受信したウィンドウIDで示される行の「キャプチャフラグ」が「1」かどうかを判別する（ステップS219）。	并且，再次判别窗口控制表 24A的由接收到的窗口 ID所表示的行的“捕获标记”是否为“1”(步骤 S219)。
そして、該ウィンドウ制御ダイアログ26Aを閉じて、このウィンドウ制御に係わる動作を終了する。	然后，关闭该窗口控制对话框 26A，结束该窗口控制所涉及的动作。
例えば、図9は、クライアント装置におけるウィンドウ制御時のウィンドウ制御ダイアログ26Aの別の例を示す図である。	例如，图 10是表示客户机装置中的窗口控制时的窗口控制对话框 26A的其他例的图。
また、図10は、クライアント装置20におけるウィンドウ制御時のウィンドウ制御ダイアログ26Aの更に別の例を示す図である。	此外，图 11是表示客户机装置 20中的窗口控制时的窗口控制对话框 26A的另一例的图。
なお、ウィンドウ201〜206のサイズおよび配置、ウィンドウの個数については、図7の態様に限定されるものではない。	再有，窗口 201～ 206的尺寸及配置、窗口的个数不限于图 7的样式。
【図2】ウィンドウをより詳細に示すとともに、該ウィンドウ内の選択画素の組を示す図である。	图 2更详细示出了窗，并示例性示出了所述窗内的选定像素集合，
この画面表示例において、「1」の表示ウィンドウを除き、表示ウィンドウへの画像表示は省略されている。	在这个示例性画面显示上，除了显示窗口“1”以外，省略了在显示窗口上显示的图像。
図8において、ステップ810では、タイムウィンドウiは複数の等継続期間サブウィンドウ（equal-duration sub windows）Sに分割される。	在图 8中，在步骤 810处，将时间窗划分为多个 (S个 )具有相等持续时间的子窗。
W1とW2に選択されるウィンドウは、本質的に相補的でよい。	对 W1和 W2选择的窗口可以在实质上是互补的。
また、前記ROM23にはさらに、サーバ装置10のウィンドウ監視マネージャ13A及びウィンドウ制御マネージャ13Bとの通信を行うためのプログラムが記憶され、前記RAM24にはさらに、サーバ装置10のウィンドウ状態を保管するためのウィンドウ制御テーブル24Aなどが記憶される。	此外，所述 ROM23中还存储着用于与服务器装置 10的窗口监视管理器 13A以及窗口控制管理器 13B进行通信的程序，在所述 RAM24中还存储着用于管理服务器装置 10的窗口状态的窗口控制表 24A等。
さらに、非アクティブ状態のウィンドウにおいて名前属性が変更になっていた場合には、当該ウィンドウがアクティブ状態になった際にウィンドウ領域のデータをキャプチャすることで、より直近のウィンドウ状態に近いキャプチャデータを取得することができる。	再有，在非激活状态的窗口中名称属性发生变更的情况下，该窗口变为激活状态时通过捕获窗口区域的数据，从而能够取得更接近于当前的窗口状态的捕获数据。
ディスプレイウィンドウ520は、ESGからチャネルを示すことができる。	显示窗口 520可展示来自 ESG的频道。
【図2】本発明にかかる方法で使用可能なウィンドウの例	图 2示出了可在本发明的过程中使用的窗的实例。
例えば、喜怒哀楽の表情や力んだ表情、顔の向き、口の開閉、目の開閉（例えば、ウィンク）等の属性を検出し、この検出結果に基づいて属性情報を生成することができる。	例如，可以检测诸如高兴、愤怒、悲伤或愉快的表情、紧张、面孔方向嘴巴表情 (口 /闭 )、眼睛表情 (例如，眨眼 )等之类的属性，并且可以基于检测结果生成属性信息。
例えば、喜怒哀楽の表情や力んだ表情、顔の向き、口の開閉、目の開閉（例えば、ウィンク）等の属性を検出し、この検出結果に基づいて属性情報を生成することができる。	例如，可以检测如喜、怒、哀、乐表情、紧张、面部方向、嘴部表情 (张开 /闭上 )、眼部表情 (例如，眨眼 )等的属性，并且可以基于检测结果生成属性信息。
例えば、喜怒哀楽の表情や力んだ表情、顔の向き、口の開閉、目の開閉（例えば、ウィンク）等の属性を検出し、この検出結果に基づいて属性情報を生成することができる。	例如，可以检测诸如高兴、愤怒、悲伤或愉快的表情、紧张、面孔方向嘴巴表情 (口 /闭 )、眼睛表情 (例如，眨眼 )等之类的属性，并且可以基于检测结果生成属性信息。
例えば、喜怒哀楽の表情や力んだ表情、顔の向き、口の開閉、目の開閉（例えば、ウィンク）等の属性を検出し、この検出結果に基づいて属性情報を生成することができる。	例如，可以检测如喜、怒、哀、乐表情、紧张、面部方向、嘴部表情 (张开 /闭上 )、眼部表情 (例如，眨眼 )等的属性，并且可以基于检测结果生成属性信息。
スウィングドア．	弹簧门
彼は優秀なウィング選手だ。	他是优秀的侧翼球员。
巻き胴ウィンチ．	滚筒绞车
ガラス窓，ショーウィンドー．	玻璃窗
本変更例では、複数のウィンドウは、6個のウィンドウ201〜206からなる。	在本变更例中，多个窗口由 6个窗口 201～ 206组成。
ウィンドウW2は、ウィンドウ702の上端と下端で1の値に近づき、ウィンドウ702の中心にゼロ値を有する。	窗口 W2在窗口 702的高端和低端达到统一值，并且在窗口 702的中心具有零值。
なお、メインウィンドウ100およびサブウィンドウ102〜106のサイズおよび配置、サブウィンドウの個数については、図3の態様に限定されるものではない。	再有，主窗口 100及子窗口 102～ 106的尺寸及配置、子窗口的个数不限于图 3的状态。
【図9】ウィンドウの対応する周波数応答を示す、図5のウィンドウのグラフである。	图 9是图 5的窗口的曲线图，其示出了所述窗口的相应频率响应。
【図10】ウィンドウの対応する周波数応答を示す、図7のウィンドウのグラフである。	图 10是图 7的窗口的曲线图，其示出了所述窗口的相应频率响应。
【図19】TCPスライディング・ウィンドウ動作を描いた図である。	图 19示出了 TCP滑动窗口操作。
上記の説明に選択されたウィンドウ502及び702はそれぞれ、Hannウィンドウ及び逆Hannウィンドウと似ているが、他のウィンドウ形状が使用されてもよい。	尽管为以上说明选择的窗口 502、702分别类似于 Hann窗口和反转 Hann窗口，但也可以使用其它窗口形状。
リーク電流＋（RX電流＊（ウィンドウ／間隔）） （1）	漏电 _电流 +(RX_电流 *(窗口 /间隔 ))(1)
タスクバーを他のウィンドウの前面に表示する	在其他窗口前面显示任务栏
その企業はウィンドジャマーを復元した。	那家企业将帆船复原了。
暗い道でショーウィンドーが明るく光っていた。	昏暗的路上，商店橱窗发出明亮的光。
たとえば、図11と図12に示されたように、2つの非対称的なウィンドウ1102及び1202が選択されてもよく、第1のウィンドウ1102は、ウィンドウ処理空間の上側半分を占め、第2のウィンドウ1202は、ウィンドウ処理空間の下側半分を占める。	例如，如图 11和图 12所示，可以选择两个非对称窗口 1102、1202，其中，第一窗口 1102占据加窗空间的上一半，而第二窗口 1202占据加窗空间的下一半。
たとえば、W1に図5に示されたウィンドウ502が選択された場合は、W2に図7のウィンドウ702が選択されてもよい。	例如，如果对 W1选择了图 5中所示的窗口 502，则可以对 W2选择图 7所示的窗口 702。
本明細書ではウィンドウ形状の特定の例を説明したが、他のウィンドウ形状が使用されてもよい。	尽管本文描述了窗口形状的特定示例，但也可以使用其它窗口形状。
図2に戻ると、ウィンドウ処理（ブロック204A及び204B）が完了した後で、被ウィンドウ処理音声ブロックがそれぞれ変換される（ブロック206A及び206B）。	返回到图 2，在完成加窗 (框 204A和 204B)之后，分别对加窗后音频块进行变换(框 206A和 206B)。
これらウィンドウ監視マネージャ13A及びウィンドウ制御マネージャ13Bは、クライアント装置20と直接通信する機能を保持している。	这些窗口监视管理器 13A以及窗口控制管理器 13B保持着与客户机装置 20直接通信的功能。
即ち、ウィンドウ新規表示を示す制御用データを受信した場合には、ウィンドウID、名前、領域を受信する（ステップS205）。	也就是说，在接收到表示窗口重新显示的控制用数据的情况下，接收窗口 ID、名称、区域 (步骤 S205)。
即ち、項目「ウィンドウID」に受信したウィンドウIDを登録し、項目「名前」に受信した名前を登録する。	也就是说，在项目“窗口 ID”中登记接收到的窗口 ID，在项目“名称”中登记接收到的名称。
一方、受信した制御用データがウィンドウ消去を示すものである時には、ウィンドウID、名前、領域を受信する（ステップS208）。	另一方面，在接收到的控制用数据表示窗口消除时，接收窗口 ID(步骤 S208)。
そして、ウィンドウ制御テーブル24Aから、その受信したウィンドウIDで示される行を削除する（ステップS209）。	然后，从窗口控制表 24A删除由该接收到的窗口 ID所表示的行 (步骤 S209)。
また、ウィンドウ属性変更を示す制御用データを受信した場合には、ウィンドウIDと名前を受信する（ステップS210）。	此外，在接收到表示窗口属性变更的控制用数据的情况下，接收窗口 ID和名称(步骤 S210)。
そして、ウィンドウ制御テーブル24Aのその受信したウィンドウIDで示される行の「名前」に、受信した名前を登録し直す（ステップS211）。	然后，在窗口控制表 24A的由该接收到的窗口 ID所表示的行的“名称”中，重新登记接收到的名称 (步骤 S211)。
そして、ウィンドウ制御テーブル24Aのその受信したウィンドウIDで示される行の「キャプチャフラグ」が「1」かどうかを判別する（ステップS215）。	然后，判别窗口控制表 24A的由该接收到的窗口 ID所表示的行的“捕获标记”是否为“1”(步骤 S215)。
そして、再度、ウィンドウ制御テーブル24Aの受信したウィンドウIDで示される行の「キャプチャフラグ」が「1」かどうかを判別する（ステップS219）。	并且，再次判别窗口控制表 24A的由接收到的窗口 ID所表示的行的“捕获标记”是否为“1”(步骤 S219)。
そして、該ウィンドウ制御ダイアログ26Aを閉じて、このウィンドウ制御に係わる動作を終了する。	然后，关闭该窗口控制对话框 26A，结束该窗口控制所涉及的动作。
例えば、図9は、クライアント装置におけるウィンドウ制御時のウィンドウ制御ダイアログ26Aの別の例を示す図である。	例如，图 10是表示客户机装置中的窗口控制时的窗口控制对话框 26A的其他例的图。
また、図10は、クライアント装置20におけるウィンドウ制御時のウィンドウ制御ダイアログ26Aの更に別の例を示す図である。	此外，图 11是表示客户机装置 20中的窗口控制时的窗口控制对话框 26A的另一例的图。
なお、ウィンドウ201〜206のサイズおよび配置、ウィンドウの個数については、図7の態様に限定されるものではない。	再有，窗口 201～ 206的尺寸及配置、窗口的个数不限于图 7的样式。
【図2】ウィンドウをより詳細に示すとともに、該ウィンドウ内の選択画素の組を示す図である。	图 2更详细示出了窗，并示例性示出了所述窗内的选定像素集合，
この画面表示例において、「1」の表示ウィンドウを除き、表示ウィンドウへの画像表示は省略されている。	在这个示例性画面显示上，除了显示窗口“1”以外，省略了在显示窗口上显示的图像。
図8において、ステップ810では、タイムウィンドウiは複数の等継続期間サブウィンドウ（equal-duration sub windows）Sに分割される。	在图 8中，在步骤 810处，将时间窗划分为多个 (S个 )具有相等持续时间的子窗。
W1とW2に選択されるウィンドウは、本質的に相補的でよい。	对 W1和 W2选择的窗口可以在实质上是互补的。
また、前記ROM23にはさらに、サーバ装置10のウィンドウ監視マネージャ13A及びウィンドウ制御マネージャ13Bとの通信を行うためのプログラムが記憶され、前記RAM24にはさらに、サーバ装置10のウィンドウ状態を保管するためのウィンドウ制御テーブル24Aなどが記憶される。	此外，所述 ROM23中还存储着用于与服务器装置 10的窗口监视管理器 13A以及窗口控制管理器 13B进行通信的程序，在所述 RAM24中还存储着用于管理服务器装置 10的窗口状态的窗口控制表 24A等。
さらに、非アクティブ状態のウィンドウにおいて名前属性が変更になっていた場合には、当該ウィンドウがアクティブ状態になった際にウィンドウ領域のデータをキャプチャすることで、より直近のウィンドウ状態に近いキャプチャデータを取得することができる。	再有，在非激活状态的窗口中名称属性发生变更的情况下，该窗口变为激活状态时通过捕获窗口区域的数据，从而能够取得更接近于当前的窗口状态的捕获数据。
ディスプレイウィンドウ520は、ESGからチャネルを示すことができる。	显示窗口 520可展示来自 ESG的频道。
【図2】本発明にかかる方法で使用可能なウィンドウの例	图 2示出了可在本发明的过程中使用的窗的实例。
【図3】信号のサンプルに対するウィンドウ化処理のブロック図	图 3示出了所采集信号的加窗过程的框图。
図2は、サンプル0を中心としたウィンドウの例である。	在图 2中可以看到以样本 0为中心的窗的实例。
同様に、ウィンドウのサンプル数は、2048よりも多くなければならない。	同样地，窗的样本数目必须大于 2048。
気晴らしのひとつとしてウィンドウショッピングを楽しむ人は多い。	有许多人当做消遣之一去享受逛街的乐趣。
その雑誌は多くのウィンドサーファーから支持されている。	那个杂志可以在很多浏览器上看。
ショーウィンドーに日本美術の展示品をセットする。	在商品橱窗里布置日本美术的展品。
このショーウィンドウはもっとディスプレイしなければならない．	这个橱窗还需要装潢一下。
図7に示されたように、ウィンドウ702は、ウィンドウW1を逆にしたもの、すなわちW2（k）＝1−W1（k）であり、ここで、kは、ウィンドウ領域内のサンプル指標である。	如图 7所示，窗口 702是窗口 W1的反转形式，即，W2(k)＝ 1-W1(k)，其中，k是窗口域内的抽样索引。
以上、第1のウィンドウ（W1）と第2のウィンドウ（W2）の選択と、取り込んだ音声のブロックの全ての署名ビットが、選択されたウィンドウを使用して決定されることを述べたが、他の構成も可能である。	尽管前面描述了选择第一窗口 (W1)和第二窗口 (W2)并且利用所选择的窗口来确定捕获的音频块的所有签名，但其它方式也是可能的。
代替の方法は、例えば、所定位置にウィンドウを接着するRTV接着材料を用いて、ウィンドウのウィンドウフレームへの応力のない取り付けを提供するようになっている。	 替代方法将是提供窗口到窗框的无压力安装，例如，使用 RTV接合材料来将所述窗口接合就位。
このウィンドウ制御ダイアログ26Aは、ウィンドウ制御テーブル24Aの各行の「名前」に登録されている名前に基づいて、「リスト一覧」にサーバ装置10で起動しているウィンドウの名前を一覧表示するものである。	该窗口控制对话框 26A基于登记在窗口控制表 24A的各行的“名称”中的名称，在“一览显示”中一览显示由服务器装置 10启动着的窗口名称。
即ち、表示コマンドを受信した場合には、受信したウィンドウIDを持つウィンドウ（アプリケーションプログラム）に対し、activeコマンドを発行することで、当該ウィンドウをアクティブ状態にする（ステップS13B4）。	也就是说，在接收到显示指令的情况下，对具有接收到的窗口 ID的窗口 (应用程序 )发布 active指令，从而使该窗口处于激活状态 (步骤 S13B4)。
また、閉じるコマンドを受信した場合には、受信したウィンドウIDを持つウィンドウ（アプリケーションプログラム）に対し、deleteコマンドを発行することで、当該ウィンドウを消去にする（ステップS13B5）。	此外，在接收到关闭指令的情况下，对具有接收到的窗口 ID的窗口 (应用程序 )发布 delete指令，从而消除该窗口 (步骤 S13B5)。
【図76】字幕ストリームにおけるウィンドゥ定義セグメント、制御情報を示す図である。	图 76是表示字幕流的窗口定义段、控制信息的图。
本変更例では、複数のウィンドウは、6個のウィンドウ201〜206からなる。	在本变更例中，多个窗口由 6个窗口 201～ 206组成。
ウィンドウW2は、ウィンドウ702の上端と下端で1の値に近づき、ウィンドウ702の中心にゼロ値を有する。	窗口 W2在窗口 702的高端和低端达到统一值，并且在窗口 702的中心具有零值。
なお、メインウィンドウ100およびサブウィンドウ102〜106のサイズおよび配置、サブウィンドウの個数については、図3の態様に限定されるものではない。	再有，主窗口 100及子窗口 102～ 106的尺寸及配置、子窗口的个数不限于图 3的状态。
【図9】ウィンドウの対応する周波数応答を示す、図5のウィンドウのグラフである。	图 9是图 5的窗口的曲线图，其示出了所述窗口的相应频率响应。
【図10】ウィンドウの対応する周波数応答を示す、図7のウィンドウのグラフである。	图 10是图 7的窗口的曲线图，其示出了所述窗口的相应频率响应。
【図19】TCPスライディング・ウィンドウ動作を描いた図である。	图 19示出了 TCP滑动窗口操作。
上記の説明に選択されたウィンドウ502及び702はそれぞれ、Hannウィンドウ及び逆Hannウィンドウと似ているが、他のウィンドウ形状が使用されてもよい。	尽管为以上说明选择的窗口 502、702分别类似于 Hann窗口和反转 Hann窗口，但也可以使用其它窗口形状。
リーク電流＋（RX電流＊（ウィンドウ／間隔）） （1）	漏电 _电流 +(RX_电流 *(窗口 /间隔 ))(1)
タスクバーを他のウィンドウの前面に表示する	在其他窗口前面显示任务栏
たとえば、図11と図12に示されたように、2つの非対称的なウィンドウ1102及び1202が選択されてもよく、第1のウィンドウ1102は、ウィンドウ処理空間の上側半分を占め、第2のウィンドウ1202は、ウィンドウ処理空間の下側半分を占める。	例如，如图 11和图 12所示，可以选择两个非对称窗口 1102、1202，其中，第一窗口 1102占据加窗空间的上一半，而第二窗口 1202占据加窗空间的下一半。
たとえば、W1に図5に示されたウィンドウ502が選択された場合は、W2に図7のウィンドウ702が選択されてもよい。	例如，如果对 W1选择了图 5中所示的窗口 502，则可以对 W2选择图 7所示的窗口 702。
本明細書ではウィンドウ形状の特定の例を説明したが、他のウィンドウ形状が使用されてもよい。	尽管本文描述了窗口形状的特定示例，但也可以使用其它窗口形状。
図2に戻ると、ウィンドウ処理（ブロック204A及び204B）が完了した後で、被ウィンドウ処理音声ブロックがそれぞれ変換される（ブロック206A及び206B）。	返回到图 2，在完成加窗 (框 204A和 204B)之后，分别对加窗后音频块进行变换(框 206A和 206B)。
これらウィンドウ監視マネージャ13A及びウィンドウ制御マネージャ13Bは、クライアント装置20と直接通信する機能を保持している。	这些窗口监视管理器 13A以及窗口控制管理器 13B保持着与客户机装置 20直接通信的功能。
即ち、ウィンドウ新規表示を示す制御用データを受信した場合には、ウィンドウID、名前、領域を受信する（ステップS205）。	也就是说，在接收到表示窗口重新显示的控制用数据的情况下，接收窗口 ID、名称、区域 (步骤 S205)。
即ち、項目「ウィンドウID」に受信したウィンドウIDを登録し、項目「名前」に受信した名前を登録する。	也就是说，在项目“窗口 ID”中登记接收到的窗口 ID，在项目“名称”中登记接收到的名称。
一方、受信した制御用データがウィンドウ消去を示すものである時には、ウィンドウID、名前、領域を受信する（ステップS208）。	另一方面，在接收到的控制用数据表示窗口消除时，接收窗口 ID(步骤 S208)。
そして、ウィンドウ制御テーブル24Aから、その受信したウィンドウIDで示される行を削除する（ステップS209）。	然后，从窗口控制表 24A删除由该接收到的窗口 ID所表示的行 (步骤 S209)。
また、ウィンドウ属性変更を示す制御用データを受信した場合には、ウィンドウIDと名前を受信する（ステップS210）。	此外，在接收到表示窗口属性变更的控制用数据的情况下，接收窗口 ID和名称(步骤 S210)。
そして、ウィンドウ制御テーブル24Aのその受信したウィンドウIDで示される行の「名前」に、受信した名前を登録し直す（ステップS211）。	然后，在窗口控制表 24A的由该接收到的窗口 ID所表示的行的“名称”中，重新登记接收到的名称 (步骤 S211)。
そして、ウィンドウ制御テーブル24Aのその受信したウィンドウIDで示される行の「キャプチャフラグ」が「1」かどうかを判別する（ステップS215）。	然后，判别窗口控制表 24A的由该接收到的窗口 ID所表示的行的“捕获标记”是否为“1”(步骤 S215)。
そして、再度、ウィンドウ制御テーブル24Aの受信したウィンドウIDで示される行の「キャプチャフラグ」が「1」かどうかを判別する（ステップS219）。	并且，再次判别窗口控制表 24A的由接收到的窗口 ID所表示的行的“捕获标记”是否为“1”(步骤 S219)。
そして、該ウィンドウ制御ダイアログ26Aを閉じて、このウィンドウ制御に係わる動作を終了する。	然后，关闭该窗口控制对话框 26A，结束该窗口控制所涉及的动作。
例えば、図9は、クライアント装置におけるウィンドウ制御時のウィンドウ制御ダイアログ26Aの別の例を示す図である。	例如，图 10是表示客户机装置中的窗口控制时的窗口控制对话框 26A的其他例的图。
また、図10は、クライアント装置20におけるウィンドウ制御時のウィンドウ制御ダイアログ26Aの更に別の例を示す図である。	此外，图 11是表示客户机装置 20中的窗口控制时的窗口控制对话框 26A的另一例的图。
なお、ウィンドウ201〜206のサイズおよび配置、ウィンドウの個数については、図7の態様に限定されるものではない。	再有，窗口 201～ 206的尺寸及配置、窗口的个数不限于图 7的样式。
【図2】ウィンドウをより詳細に示すとともに、該ウィンドウ内の選択画素の組を示す図である。	图 2更详细示出了窗，并示例性示出了所述窗内的选定像素集合，
この画面表示例において、「1」の表示ウィンドウを除き、表示ウィンドウへの画像表示は省略されている。	在这个示例性画面显示上，除了显示窗口“1”以外，省略了在显示窗口上显示的图像。
図8において、ステップ810では、タイムウィンドウiは複数の等継続期間サブウィンドウ（equal-duration sub windows）Sに分割される。	在图 8中，在步骤 810处，将时间窗划分为多个 (S个 )具有相等持续时间的子窗。
W1とW2に選択されるウィンドウは、本質的に相補的でよい。	对 W1和 W2选择的窗口可以在实质上是互补的。
また、前記ROM23にはさらに、サーバ装置10のウィンドウ監視マネージャ13A及びウィンドウ制御マネージャ13Bとの通信を行うためのプログラムが記憶され、前記RAM24にはさらに、サーバ装置10のウィンドウ状態を保管するためのウィンドウ制御テーブル24Aなどが記憶される。	此外，所述 ROM23中还存储着用于与服务器装置 10的窗口监视管理器 13A以及窗口控制管理器 13B进行通信的程序，在所述 RAM24中还存储着用于管理服务器装置 10的窗口状态的窗口控制表 24A等。
さらに、非アクティブ状態のウィンドウにおいて名前属性が変更になっていた場合には、当該ウィンドウがアクティブ状態になった際にウィンドウ領域のデータをキャプチャすることで、より直近のウィンドウ状態に近いキャプチャデータを取得することができる。	再有，在非激活状态的窗口中名称属性发生变更的情况下，该窗口变为激活状态时通过捕获窗口区域的数据，从而能够取得更接近于当前的窗口状态的捕获数据。
ディスプレイウィンドウ520は、ESGからチャネルを示すことができる。	显示窗口 520可展示来自 ESG的频道。
【図2】本発明にかかる方法で使用可能なウィンドウの例	图 2示出了可在本发明的过程中使用的窗的实例。
【図3】信号のサンプルに対するウィンドウ化処理のブロック図	图 3示出了所采集信号的加窗过程的框图。
図2は、サンプル0を中心としたウィンドウの例である。	在图 2中可以看到以样本 0为中心的窗的实例。
同様に、ウィンドウのサンプル数は、2048よりも多くなければならない。	同样地，窗的样本数目必须大于 2048。
気晴らしのひとつとしてウィンドウショッピングを楽しむ人は多い。	有许多人当做消遣之一去享受逛街的乐趣。
このショーウィンドウはもっとディスプレイしなければならない．	这个橱窗还需要装潢一下。
図7に示されたように、ウィンドウ702は、ウィンドウW1を逆にしたもの、すなわちW2（k）＝1−W1（k）であり、ここで、kは、ウィンドウ領域内のサンプル指標である。	如图 7所示，窗口 702是窗口 W1的反转形式，即，W2(k)＝ 1-W1(k)，其中，k是窗口域内的抽样索引。
以上、第1のウィンドウ（W1）と第2のウィンドウ（W2）の選択と、取り込んだ音声のブロックの全ての署名ビットが、選択されたウィンドウを使用して決定されることを述べたが、他の構成も可能である。	尽管前面描述了选择第一窗口 (W1)和第二窗口 (W2)并且利用所选择的窗口来确定捕获的音频块的所有签名，但其它方式也是可能的。
代替の方法は、例えば、所定位置にウィンドウを接着するRTV接着材料を用いて、ウィンドウのウィンドウフレームへの応力のない取り付けを提供するようになっている。	 替代方法将是提供窗口到窗框的无压力安装，例如，使用 RTV接合材料来将所述窗口接合就位。
このウィンドウ制御ダイアログ26Aは、ウィンドウ制御テーブル24Aの各行の「名前」に登録されている名前に基づいて、「リスト一覧」にサーバ装置10で起動しているウィンドウの名前を一覧表示するものである。	该窗口控制对话框 26A基于登记在窗口控制表 24A的各行的“名称”中的名称，在“一览显示”中一览显示由服务器装置 10启动着的窗口名称。
即ち、表示コマンドを受信した場合には、受信したウィンドウIDを持つウィンドウ（アプリケーションプログラム）に対し、activeコマンドを発行することで、当該ウィンドウをアクティブ状態にする（ステップS13B4）。	也就是说，在接收到显示指令的情况下，对具有接收到的窗口 ID的窗口 (应用程序 )发布 active指令，从而使该窗口处于激活状态 (步骤 S13B4)。
また、閉じるコマンドを受信した場合には、受信したウィンドウIDを持つウィンドウ（アプリケーションプログラム）に対し、deleteコマンドを発行することで、当該ウィンドウを消去にする（ステップS13B5）。	此外，在接收到关闭指令的情况下，对具有接收到的窗口 ID的窗口 (应用程序 )发布 delete指令，从而消除该窗口 (步骤 S13B5)。
画面イメージ領域26A1に破線で示すウィンドウは、別のウィンドウの下に全体が隠れてしまって見えないウィンドウを表している。	在画面图片区域 26A1中由虚线表示的窗口，其整体隐藏在其他窗口的下方，示出的是看不见的窗口。
この複数のウィンドウは、比較的大きいサイズの画面（以下、メイン画面ともいう）である1個のメインウィンドウ100と、メイン画面よりも小さいサイズの画面（以下、サブ画面ともいう）である3個のサブウィンドウ102，104，106とからなる。	比较大的尺寸的画面 (以下也称为主画面 )即 1个主窗口 100； 和比主画面小的尺寸的画面 (以下也称为子画面 )即 3个子窗口102、104、106构成。
各APは、その他のAPのタイミング・ウィンドウと同じ時間にスケジュールされた、自己のタイミング・ウィンドウを有しうるか、あるいはタイミング・ウィンドウが、異なる時間にスケジュールされうる。	每个 AP可以将其时间窗口安排在与其它 AP的时间窗口相同的时间，也可以将其时间窗口安排在与其它 AP的时间窗口不同的时间。
しかしながら、隣接する画素は、各スリットと協働して、ウィンドウ平面12内のウィンドウ10および11の両側に位置される追加のビューウィンドウ（図示せず）を形成し得る。	然而，相邻的像素可以和各个狭缝相互配合，以便在窗口平面 12上形成位于窗口 10和 11任一侧的其它观察窗口 (未示出 )。
なお、このウィンドウ制御マネージャ13Bによってウィンドウ制御が行なわれたことにより、起動しているウィンドウに変化が生じるので、その変化によりウィンドウ監視マネージャ13Aが前述したような動作を行ない、クライアント装置20のウィンドウ制御テーブル24Aも前述したように更新されることは言うまでもない。	此外，通过由该窗口控制管理器 13B进行窗口控制，由于启动着的窗口发生变化，因此，当然窗口监视管理器 13A也会根据其变化进行上述那样的动作，客户机装置 20的窗口控制表 24A也会如上述那样被更新。
これらの方法の他に、各監視カメラの表示ウィンドウサイズを設定する方法として、各監視カメラの表示ウィンドウの大きさを示す棒グラフの仕切り線を移動すること、あるいは表示ウィンドウのサイズを表す数値を入力すること等も考えられる。	除了其他方法以外，为了设定每个监视相机的显示窗口的大小，例如，可以移动指示出监视相机的显示窗口的大小的条形图的边界线，或者可以输入指示出显示窗口的大小的数值。
例えば、アプリケーションプログラムとしてWebブラウザでは、そのウィンドウが非アクティブな状態であっても、自動的に別のWebページに移動するような場合があり、そのような場合には名前属性が変更される。	例如，作为应用程序在 Web浏览器中，即便其窗口是非激活状态，也存在自动转移至其他 Web页面的情况，在这种情况下名称属性被变更。
トランスミッタ309が、ACK通知がレシーバ307によって提供されたことを決定する場合（B510）、トランスミッタは、バッファ再送信ウィンドウを前方へと移動させることにより次のパケットへと進むことができる（B530）。	如果发射器 309确定 ACK通知由接收器 307提供 (B510)，则发射器可通过将缓冲重发窗向前移动而继续进行到下一包 (B530)。
最初、ユーザはユーザ操作部132を構成するマウス等を用いて、図7（b）に示すように、表示ウィンドウのサイズが所定値以下の範囲に、エンコードビットレートが一定の下限値を示す直線L1を引く。	最初，用户拖动用户操作单元 132的鼠标等等以描绘直线 L1，直线 L1指示出在显示窗口的大小等于或小于预定值的范围中编码比特率的给定下限，如图 7B所示。
音声ブロックにウィンドウ関数を適用した後で他の技術が使用されてもよい。	可以在将窗口函数应用于音频块之后使用其他技术。
一例では、ウィンドウ処理は、ウィンドウ関数の値と音声ブロックのそれぞれのサンプルの間のサンプルに関しての乗算（sample−wise multiplication）である。	在一个示例中，加窗是窗口函数的值与音频块的各样本之间的样本方面的乘法 (sample-wise multiplication)。
すべてのチャンキングアルゴリズムは、スモールウィンドウ（小型のウィンドウ）、すなわち限られたバイトシーケンスに依存するフィンガプリント関数またはハッシュを使用する。	所有的拆分信息块算法都使用取决于小窗口 (即有限字节序列 )的指纹函数或散列 (hash)。
所与の位置では、このフィンガプリント関数は、このオブジェクト中のバイト位置を囲む小さなデータウィンドウを使用して計算される。	对于一给定位置，使用包围对象中位置的小数据窗口来计算指纹函数；
したがって、このフィンガプリント（指紋）関数の値は、このウィンドウ内に含まれるオブジェクトのすべてのバイトに依存する。	指纹函数的值取决于包括在该窗口的对象的所有字节数。
以前に説明したように、各フィンガプリント関数は、そのオブジェクト中の位置を囲む小さなデータウィンドウを使用する。	如前所述，每个指纹函数都使用包围对象中位置的小数据窗口；
ここで、このフィンガプリント関数に関連する値は、このデータウィンドウの内側に含まれるこのオブジェクトのすべてのバイトに依存する。	其中关联于指纹函数的值取决于包括在数据窗口内的对象的所有字节数。
ここで、表示ウィンドウサイズをx、エンコードビットレートをyとするとき、カメラ1のプロファイルは、y＝5k＊x（kは定数）の一次関数で表されている。	这里，假定 x是显示窗口的大小，并且 y是编码比特率，则相机 1的配置特性由线性函数 y＝ 5k*x(其中 k是常数 )来表达。
ここで、表示ウィンドウサイズをx、エンコードビットレートをyとするとき、カメラ1のプロファイルは、y＝5k＊x（kは定数）の一次関数で表されている。	这里，假定 x是显示窗口的大小并且 y是编码比特率，则相机 1的配置特性由线性函数 y＝ 5k*x(其中 k是常数 )来表达。
これらウィンドウ監視マネージャ13A及びウィンドウ制御マネージャ13Bは、クライアント装置20と直接通信する機能を保持している。	这些窗口监视管理器 13A以及窗口控制管理器 13B保持着与客户机装置 20直接通信的功能。
なお、メインウィンドウ100およびサブウィンドウ102〜106には、映像信号に基づく映像とともに、後述するOSD機能によって、該映像信号に対応する「入力端子名」を重畳して表示させる。	再有，在主窗口 100及子窗口 102～ 106中，与基于影像信号的影像一起，通过后述的 OSD功能，重叠显示对应该影像信号的“输入端子名称”。
入力装置17で所定のユーザ操作を行なうことにより、該フローチャートに示すようなウィンドウ制御機能を実現するプログラムが起動されると、まず、ウィンドウ制御テーブル24Aのデータを使用して、ウィンドウ制御ダイアログを作成し、表示装置26に全画面表示する（ステップS241）。	在通过由输入装置 17进行规定的用户操作，来启动实现该流程图所示的窗口控制功能的程序时，首先，使用窗口控制表 24A的数据制作窗口控制对话框，在显示装置 26进行全画面显示 (步骤 S241)。
また、ウィンドウ201〜206には、上述したOSD機能によって、映像信号に基づく映像とともに、該映像信号に対応する「入力端子名」が重畳して表示されている。	此外，在窗口 201～ 206中，根据上述的 OSD功能，与基于影像信号的影像一起，重叠显示与该影像信号对应的“输入端子名称”。
当業者であれば、図8に示された例示的な実施形態は、Nsがしきい値Tsよりも小さいときにのみサブウィンドウからのパルスをカウントする機能を果たす。	所属领域的技术人员将认识到，图 8中所示的示范性实施例用以仅在 Ns小于阈值Ts时对来自子窗 s的脉冲进行计数。
表示制御部340は、リスト取得応答に含まれるコンテンツリストの中から入力情報判断部320により選択されたデータを詳細情報ウィンドウ382に表示させる機能を有していてもよい。	显示控制单元 340具有在详细信息窗口 382中显示由输入信息确定单元 320从包含在列表获取响应中的内容列表中选择的数据的功能。
別の例として、ネットワーク機器（110）は、ワシントン州レッドモンドのマイクロソフト社が提供しているマイクロソフト・ウィンドウズ(登録商標)・ネットワークなど利用可能な1つ以上のネットワーク管理プロトコルのネットワーク管理機能性を実装しているドメインコントローラーであり得る。	 作为另一示例，联网设备110可以是实现一个或多个网络管理协议的网络管理功能的域控制器，诸如可从华盛顿州雷蒙德市的微软公司购买到的微软Windows网络中的域控制器。
この場合、現在の表示ウィンドウサイズとエンコードビットレートを合わせて表示することで、ユーザに、現在の表示ウィンドウサイズに対応するエンコードビットレートを認識させることができる。	在此情况下，当以组合的方式显示当前的显示窗口的大小和编码比特率时，用户可以识别出与当前的显示窗口的大小相对应的编码比特率。
【図13】各監視カメラの表示ウィンドウサイズを設定する際に、対応するプロファイルを表示することを示す図である。	图 13是示出当设定监视相机的显示窗口的大小时的对应配置特性的显示的示图。
図5（a）〜（d）、図6（a）〜（f）は、表示ウィンドウサイズとエンコードビットレートとの対応関係の一例を示している。	图 5A至 5D和图 6A至 6F是示出显示窗口的大小与编码比特率之间的对应关系的示例的示图。
制御部131は、各カメラのプロファイルから各カメラの表示ウィンドウサイズに対応したエンコードビットレートを求める。	控制单元 131根据各个相机的配置特性计算各个相机的与显示窗口的大小相对应的编码比特率。
【図12】各監視カメラの表示ウィンドウサイズを変更する例の表示形式（タイル表示、オーバラップ表示）を説明するための図である。	图 12A至 12C是示出改变监视相机的显示窗口的大小的示例中的显示格式 (瓦片状显示和交叠显示 )的示图。
例えば、OSD部136は、表示ウィンドウサイズとエンコードビットレートとの対応関係（プロファイル）の設定時に、設定用のUI（User Interface）画面を表示するための表示信号を発生する。	例如，当设定显示窗口的大小与编码比特率之间的对应关系 (配置特性 )时，OSD单元 136生成用于显示设定 UI(用户界面 )画面的显示信号。
監視装置103の制御部131は、上述したように監視カメラ101-1〜101-6のエンコードビットレートの決定を、表示ウィンドウサイズとエンコードビットレートとの対応関係に基づいて行う。	监视装置 103的控制单元 131基于显示窗口的大小与编码比特率之间的对应关系来确定监视相机 101-1至 101-6中每一个的编码比特率，如上所述。
監視装置103において、ユーザは、この表示ウィンドウサイズとエンコードビットレートとの対応関係を、監視カメラ101-1〜101-6のそれぞれに対して独立して設定可能とされている。	在监视装置 103中，用户可以为监视相机 101-1至 101-6独立地设定显示窗口的大小与编码比特率之间的对应关系。
このような表示ウィンドウサイズとエンコードビットレートとの対応関係（プロファイル）の設定時に、制御部131の制御により、OSD部136では、設定用のUI画面を表示するための表示信号が発生される。	当显示窗口的大小与编码比特率之间的对应关系 (配置特性 )被设定时，OSD单元 136在控制单元 131的控制下生成用于显示设定 UI画面的显示信号。
監視装置103の制御部131は、上述したように監視カメラ101-1〜101-6のエンコードビットレートの決定を、プロファイル（表示ウィンドウサイズとエンコードビットレートとの対応関係）に基づいて行う。	监视装置 103的控制单元 131基于配置特性 (显示窗口的大小与编码比特率之间的对应关系 )来确定监视相机 101-1至 101-6的编码比特率，如上所述。
このステップST14において、制御部131は、オプション非設定カメラのプロファイルから各カメラの表示ウィンドウサイズに対応したエンコードビットレートを求める。	在步骤 ST14中，控制单元 131根据未设定该选项的相机的配置特性，计算每个相机的与显示窗口的大小相对应的编码比特率。
このステップST16において、制御部131は、オプション設定カメラのプロファイルから、そのカメラの表示ウィンドウサイズに対応したエンコードビットレートを求める。	在步骤 ST16中，控制单元 131根据设定了该选项的相机的配置特性，计算该相机的与显示窗口的大小相对应的编码比特率。
このステップST20において、制御部131は、オプション非設定カメラのプロファイルから各カメラの表示ウィンドウサイズに対応したエンコードビットレートを求める。	在步骤 ST20中，控制单元 131根据未设定该选项的相机的配置特性，计算每个相机的与显示窗口的大小相对应的编码比特率。
ここで、表示ウィンドウサイズをx、エンコードビットレートをyとするとき、カメラ1のプロファイルは、y＝5k＊x（kは定数）の一次関数で表されている。	这里，假定 x是显示窗口的大小，并且 y是编码比特率，则相机 1的配置特性由线性函数 y＝ 5k*x(其中 k是常数 )来表达。
ここで、表示ウィンドウサイズをx、エンコードビットレートをyとするとき、カメラ1のプロファイルは、y＝5k＊x（kは定数）の一次関数で表されている。	这里，假定 x是显示窗口的大小并且 y是编码比特率，则相机 1的配置特性由线性函数 y＝ 5k*x(其中 k是常数 )来表达。
しかし、この発明は、表示ウィンドウサイズの変更に伴って、図12（a），（c）に示すように、一部の表示ウィンドウが重なるオーバラップ表示が行われる場合にも、同様に適用できる。	然而，本发明的实施例同样适用于交叠显示，其中随着显示窗口的大小被改变，显示窗口部分相互交叠，如图 12和 12C所示。
また、図1に示す監視カメラシステム100を構成する監視装置103において、各監視カメラの表示ウィンドウサイズの設定を、以下のような方法で行う旨を説明した。	在图 1中的监视相机系统 100的监视装置 103中可根据以下方法来设定每个监视相机的显示窗口的大小。
また、図1に示す監視カメラシステム100を構成する監視装置103において、各監視カメラの表示ウィンドウサイズを設定する際、図13に示すように、対応するプロファイルのグラフを表示するようにしてもよい。	当在图 1中的监视相机系统 100的监视装置 103中设定每个监视相机的显示窗口的大小时，可以显示相应配置特性的曲线图，如图 13所示。
本実施形態においては通信品質は変調方式によって判定されるが、広域ネットワーク106においてTCP／IPが用いられた場合は、ウィンドウサイズなどでもよい。	在本实施方式中，通信品质是通过调制方式来判断的，但在广域网 106中使用了TCP/IP的情况下也可以通过窗口尺寸等来判断。
各実施例では、その適切なウィンドウサイズおよびチャンキングパラメータは、このチャンキングプロシージャがその特定のアプリケーションに基づいて最適化される適切な細分性を有するように異なる場合もある。	对于每个示例，适当的窗口尺寸和拆分参数可能是不同的，从而使拆分过程具有适当的基于特定应用而最优化的粒度。
これらのアルゴリズムが有限の差分（強度削減）最適化に従うとき、チャンキングのために使用されるハッシュアルゴリズムの実行時間は、このハッシュウィンドウサイズから独立している。	当那些算法适合有限差分 (强度缩减 )优化时，用于拆分信息块的散列算法的执行时间不依赖散列窗口尺寸。
上述したように、図1の監視カメラシステム100を構成する監視装置103において、制御部131は、各監視カメラのエンコードビットレートを、表示ウィンドウサイズとエンコードビットレートとの対応関係（プロファイル）に基づいて決定する。	在图 1中的监视相机系统 100的监视装置 103中，如上所述，控制单元 131基于显示窗口的大小与编码比特率之间的对应关系 (配置特性 )来确定每个监视相机的编码比特率。
また、図1の監視カメラシステム100を構成する監視装置103の制御部131は、監視カメラ101-1〜101-6の少なくともいずれかの表示ウィンドウサイズ変更があったとき、各監視カメラのエンコードビットレートの決定およびその情報の送信を行う。	图1中的监视相机系统100的监视装置103的控制单元131在针对监视相机101-1至 101-6的至少一个的显示窗口的大小被改变时确定每个监视相机的编码比特率并发送关于编码比特率的信息。
また、図1に示す監視カメラシステム100を構成する監視装置103において、表示ウィンドウサイズを変更する例として、図12（a），（b）に示すように、各表示ウィンドウが重ならないタイル表示が維持される例を示した（図4（a），（b）参照）。	在图 1中的监视相机系统 100的监视装置 103中，实现瓦片状显示以使得显示窗口不相互交叠的示例 (参见图 4A和 4B)被示为改变显示窗口的大小的示例，如图 12A和12B所示。
これらの方法の他に、各監視カメラの表示ウィンドウサイズを設定する方法として、各監視カメラの表示ウィンドウの大きさを示す棒グラフの仕切り線を移動すること、あるいは表示ウィンドウのサイズを表す数値を入力すること等も考えられる。	除了其他方法以外，为了设定每个监视相机的显示窗口的大小，例如，可以移动指示出监视相机的显示窗口的大小的条形图的边界线，或者可以输入指示出显示窗口的大小的数值。
ほとんどのアプリケーションプログラムは、関連するファイルタイプを有するので、このファイルタイプは、そのウィンドウサイズおよびそのチャンキングパラメータを調整するに際して考慮に値する可能性のある1つの判断基準である。	因为大多数应用程序具有相关联文件类型，该文件类型是值得在调整窗口尺寸和拆分参数中考虑的一个可能标准。
また、前記一実施形態では、プレビューデータをクライアント装置20側で作成するとしたが、サーバ装置10側でウィンドウ監視マネージャ13Aが起動しているウィンドウの変更を検出した際に、該ウィンドウ監視マネージャ13Aであるいは当該ウィンドウのアプリケーションプログラムによってプレビューデータを作成して、クライアント装置20側に送信するようにしても良い。	此外，在所述一实施方式中，虽然在客户机装置 20侧制作预览数据，但也可以在服务器装置 10侧窗口监视管理器 13A检测到启动着的窗口的变更时，由该窗口监视管理器13A或该窗口的应用程序来制作预览数据，并发送至客户机装置 20侧。
このウィンドウは、注釈を作成するために、ユーザがテキストボックス412内に文字入力できるようにする。	该窗口允许用户在文本框 412中输入文本以创建注释。
入力装置17で所定のユーザ操作を行なうことにより、該フローチャートに示すようなウィンドウ制御機能を実現するプログラムが起動されると、まず、ウィンドウ制御テーブル24Aのデータを使用して、ウィンドウ制御ダイアログを作成し、表示装置26に全画面表示する（ステップS241）。	在通过由输入装置 17进行规定的用户操作，来启动实现该流程图所示的窗口控制功能的程序时，首先，使用窗口控制表 24A的数据制作窗口控制对话框，在显示装置 26进行全画面显示 (步骤 S241)。
この場合、図4（B）に示すようなウィンドウ制御ダイアログ26Aを用いるのであれば「Preview」領域に合わせた前記所定サイズに縮小して、また、図10に示すようなウィンドウ制御ダイアログ26Aであれば、予め判別しているクライアント装置20の表示装置26のサイズに合わせてリサイズして、プレビューデータを作成すれば良い。	该情况下，如果使用图 8所示的窗口控制对话框 26A，则缩小至符合“Preview”区域的所述规定尺寸； 此外，如果是图11所示的窗口控制对话框26A，则使其尺寸符合预先判别的客户机装置20的显示装置 26的尺寸来制作预览数据即可。
そして、サーバ装置10では、前記クライアント装置20からのイベント信号に応じたアプリケーションプログラム（テキスト作成処理プログラム，Webブラウザプログラム，表計算処理プログラム，メール処理プログラム，等）をマルチウィンドウにより実行させて処理を行い、この処理に伴って生成された表示用の画面データを画面更新情報として、その描画更新の都度、クライアント装置20へ転送して、クライアント装置20の表示装置に画面表示させる。	然后，在服务器装置 10中，由多窗口来执行与来自所述客户机装置 20的事件信号相应的应用程序 (文本制作处理程序、Web浏览器程序、表计算处理程序、邮件处理程序等 )从而进行处理，将伴随该处理所生成的显示用画面数据作为画面更新数据，在每次进行描绘更新时传输至客户机装置 20，使客户机装置 20的显示装置进行画面显示。
即ち、新しくウィンドウが表示された時（新規表示）には、システムプログラム又はアプリケーションプログラムより、そのウィンドウID、名前、領域（座標と大きさ）を取得して（ステップS13A3）、それらの情報をウィンドウ新規表示を示す制御用データと共に通信I／F19によりクライアント装置20に送信する（ステップS13A4）。	也就是说，在显示新的窗口时 (重新显示 )，由系统程序或应用程序取得其窗口ID、名称、区域 (坐标和大小 )(步骤 S13A3)，通过通信 I/F19将这些信息与表示窗口重新显示的控制用数据一起发送至客户机装置 20(步骤 S13A4)。
たとえば、図11と図12に示されたように、2つの非対称的なウィンドウ1102及び1202が選択されてもよく、第1のウィンドウ1102は、ウィンドウ処理空間の上側半分を占め、第2のウィンドウ1202は、ウィンドウ処理空間の下側半分を占める。	例如，如图 11和图 12所示，可以选择两个非对称窗口 1102、1202，其中，第一窗口 1102占据加窗空间的上一半，而第二窗口 1202占据加窗空间的下一半。
図2に戻ると、ウィンドウ処理（ブロック204A及び204B）が完了した後で、被ウィンドウ処理音声ブロックがそれぞれ変換される（ブロック206A及び206B）。	返回到图 2，在完成加窗 (框 204A和 204B)之后，分别对加窗后音频块进行变换(框 206A和 206B)。
【図3】信号のサンプルに対するウィンドウ化処理のブロック図	图 3示出了所采集信号的加窗过程的框图。
また603は、画像の特定部分における処理結果を表示する効果確認ウィンドウである。	附图标记 603表示用于显示对图像的特定部分的处理结果的效果查看窗口。
水平ノイズ処理回路513では、垂直検出ウィンドウ信号（VWDET）と水平検出ウィンドウ信号（HWIN）で定められた列オフセット検出期間（検出領域）内で、これらの動作が水平画素毎に順次行われる。	水平噪声处理电路 513在由垂直检测窗信号 (VWDET)和水平检测窗信号 (HWIN)指定的列偏移检测期间 (检测区域 )内对各个水平像素顺序地执行这些操作。
一例では、ウィンドウ処理は、ウィンドウ関数の値と音声ブロックのそれぞれのサンプルの間のサンプルに関しての乗算（sample−wise multiplication）である。	在一个示例中，加窗是窗口函数的值与音频块的各样本之间的样本方面的乘法 (sample-wise multiplication)。
非対称ウィンドウ1102及び1202の周波数応答は、図11と図12に参照数字1104及び1204で示されたものと同一であるが、ウィンドウが、音声ブロックのほとんど別々の部分で動作するので、ウィンドウ処理の結果は、正弦波でない音声信号に様々なスペクトル特性を有する。	非对称窗口 1102、1202的频率响应相同，如图 11和图 12附图标记 1104和 1204处所示，但是因为窗口作用于音频块的大部分不同的部分上，因此加窗的结果对于不是正弦曲线的音频信号具有不同的频谱特性。
次に、クエリー通信処理部11によるステップS103のクエリー送信処理を図14に示すフローチャート及び図15に示すウィンドウを用いて説明する。	接下来，通过参照图 14的流程图和图 15的窗口来说明在 S103的查询发送处理单元 11的处理。
処理ユニット417は、例えば、ウィンドウイング及び／あるいは巡回プレフィックス挿入のような追加の信号処理を、時間領域信号S’（t）に対して実行するように構成されうる。	处理单元 417用于对时域信号 S’(t)执行额外的信号处理，诸如，比方说，加窗和 /或循环前缀插入。
処理ユニット607a乃至607nは、例えば、ウィンドウイング及び／あるいは巡回プレフィックス挿入のような追加の信号処理を、持間領域信号S1（t）乃至SN（t）に実行するように構成されうる。	处理单元 607a-607n用于对时域信号 S1(t)到 SN(t)执行额外的信号处理，诸如，比方说，加窗和 /或循环前缀插入。
1 プロジェクタ、3A，3B 通信ケーブル、4 リモコン、7A，7B 伝送路、9 入力部、11〜14 入力端子、21 DVIレシーバ、22 HDMIレシーバ、23 A／Dコンバータ、24 Videoデコーダ、30 入力選択部、31〜34 入力部、35 切替入力部、36，37 出力端子、40 メモリ、42，44 スケーリング部、46 映像信号処理部、48 OSDメモリ、50 液晶表示駆動部、52 光学系、60 制御部、62 保存部、64 操作受付部、100 メインウィンドウ、102，104，106 サブウィンドウ、201〜206 ウィンドウ、400 通常映像表示用メモリ領域、401〜40n 履歴映像用メモリ領域、SC スクリーン。	1 投影机，3A、3B 通信电缆，4 遥控器，7A、7B 传输线路，9 输入部，11～ 14 输入端子，21 DVI接收机，22 HDMI接收机，23 A/D转换器，24 Video解码器，30 输入选择部，31～ 34 输入部，35 切换输入部，36、37 输出端子，40 存储器，42、44 尺度转换 (scaling)部，46 影像信号处理部，48 OSD存储器，50 液晶显示驱动部，52 光学系统，60 控制部，62 保存部，64 操作接受部，100 主窗口，102、104、106 子窗口，201～ 206 窗口，400 常规影像显示用存储器区域，401～ 40n 历史影像用存储器区域，SC 屏幕
この変換を使用して、被ウィンドウ処理音声ブロック内の周波数成分を分析し、各周波数成分のスペクトル・パワーを識別することができる。	可以使用该变换来分析加窗后音频块中的频率成份并标识各频率成份的频谱功率。
詳細には、この例示的な署名生成システム1500を使用して、前述のような音声ブロックのウィンドウ処理、変換、特徴付け、比較に基づいて被監視署名及び／又は基準署名を生成してもよい。	具体地说，示例性签名生成系统 1500可以用于基于上述的对音频块进行加窗、变换、特征化以及比较来生成被监测签名和 /或基准签名。
第2スケーリング部44は、履歴映像表示モードでのサブウィンドウ（図3）の表示サイズに応じて、映像信号の表す映像の解像度の変換処理を実行する。	第二尺度转换部 44，按照历史影像显示模式中的子窗口 (图 3)的显示尺寸，执行影像信号所表示的影像的分辨率的转换处理。
この解像度変換処理によって、第2スケーリング部44は、サブウィンドウの表示サイズに相当する解像度を有する履歴映像を表す映像データを生成する。	通过此分辨率转换处理，第二尺度转换部 44生成表示具有相当于子窗口的显示尺寸的分辨率的历史影像的影像数据。
該効果確認ウィンドウ603への表示としては、スライドバー602が右端に設定された状態、すなわち本実施形態の回復処理を行った結果の表示をデフォルトとする。	假设效果查看窗口 603显示在默认状态下滑动条 602被设置在右端的状态，即通过执行本实施例中的恢复处理而获得的结果。
情報処理装置300は、表示画面381に取得したデータC81〜C100（ただし、データC96、C100は、空きスペース）のアイコンを表示し、ユーザによって選択されているデータC81を詳細情報ウィンドウ382内に表示している。	信息处理设备 300在显示屏幕 381上显示获得的数据 C81至C100(然而数据 C96、C100是空空间 )的图标，并且在详细信息窗口 382内显示用户选择的数据 C81。
クエリー送信部104は、処理開始時に、現在時刻を含む送信ウィンドウの単位区間（クエリー送信処理開始基準時刻t0から単位時間T2（例えば2秒）毎に区分けした期間）の番号を示す数字nを0に初期化し、mを最終区間の番号に初期化する。	 单位时间段是从发送查询的开始时间 t0的时间序列除以单位时间 T2(例如 2秒 )的时间段。  此外，查询发送单元 104将“m”初始化为最后单位时间段的数目。
したがって、そのような比較により16個の異なる中間値（たとえば、d0，d1，d2，．．．d15）が得られ、各中間値は、たとえば被ウィンドウ処理音声ブロックの変換によって得られるスペクトルの類似周波数帯の特徴の違いである。	因此，这种比较结果得到 16种不同的中间值 (例如，d0，d1，d2…d15)，其中，各中间值是例如对加窗后音频块进行变换得到的频谱的相似频段的特征的差。
本発明は、前記の点に鑑みてなされたもので、ウィンドウの切替時に処理の遅延を少なくすることが可能なシンクライアントシステム、サーバ装置、クライアント装置及びプログラムを提供することを目的とする。	本发明是鉴于上述问题点而进行的，其目的在于提供一种瘦客户机系统、服务器装置、以及客户机装置，能减少窗口切换时的处理延迟。
「ウィンドウID」、「名前」及び「アクティブフラグ」は、サーバ装置10から送られてくる制御用データ（詳細は後述）に基づき設定され、「キャプチャフラグ」及び「キャプチャデータ保管場所」は、当該クライアント装置20の内部処理に使用するものである。	“窗口 ID”、“名称”以及“激活标记”基于从服务器装置 10发送来的控制用数据 (详细内容后面叙述 )进行设定，“捕获标记”以及“捕获数据保管位置”在该客户机装置 20的内部处理中使用。
第2スケーリング部44は、入力端子11が入力する映像信号（DVI信号）に、解像度変換処理を施すことによって、サブウィンドウの表示サイズに相当する解像度を有する履歴映像を表す映像データを生成する。	第二尺度转换部 44通过对输入端子 11输入的影像信号 (DVI信号 )实施分辨率转换处理，来生成表示具有相当于子窗口的显示尺寸的分辨率的历史影像的影像数据。
第2スケーリング部44は、入力端子12が入力する映像信号（HDMI信号）に、解像度変換処理を施すことによって、サブウィンドウの表示サイズに相当する解像度を有する履歴映像を表す映像データを生成する。	第二尺度转换部 44，通过对输入端子 12输入的影像信号 (HDMI信号 )实施分辨率转换处理，来生成表示具有相当于子窗口的显示尺寸的分辨率的历史影像的影像数据。
第2スケーリング部44は、入力端子Input1（DVI端子）が入力する映像信号（DVI信号）に、解像度変換処理を施すことによって、ウィンドウ（図7）の表示サイズに相当する解像度を有する履歴映像を表す映像データを生成する。	第二尺度转换部 44通过对输入端子 Input1(DVI端子 )输入的影像信号 (DVI信号 )实施分辨率转换处理，来生成表示具有相当于窗口 (图 7)的显示尺寸的分辨率的历史影像的影像数据。
また、効果確認ウィンドウ603への表示対象となる画像の特定部分としては、偽色の発生しやすい箇所が選択されることが望ましいが、例えば画像の一部に限らず、想定される特定のサンプル画像に対する処理結果を表示しても良い。	优选地，选择容易受到伪色生成的影响的部分作为图像的特定部分，该特定部分是效果查看窗口 603的显示目标。
図15に示されたように、例示的な署名生成システム1500は、サンプル・ジェネレータ1502、タイミング装置1503、基準時間ジェネレータ1504、ウィンドウ処理器（windower）1506、トランスフォーマ1508、特徴決定器（characteristic determiner）1510、比較器1512、署名決定器1514、記憶装置1516及びデータ通信インタフェース1518を含み、これらはすべて、図示したように通信可能に結合されてもよい。	如图 15所示，示例性签名生成系统 1500包括样本生成器 1502、定时装置 1503、基准时间生成器 1504、加窗器 1506、变换器 1508、特征确定器 1510、比较器 1512、签名确定器1514、存储器 1516和数据通信接口 1518，如图所示，所有这些都可以可通信地连接。
そして、サーバ装置10では、前記クライアント装置20からのイベント信号に応じたアプリケーションプログラム（テキスト作成処理プログラム，Webブラウザプログラム，表計算処理プログラム，メール処理プログラム，等）をマルチウィンドウにより実行させて処理を行い、この処理に伴って生成された表示用の画面データを画面更新情報として、その描画更新の都度、クライアント装置20へ転送して、クライアント装置20の表示装置に画面表示させる。	然后，在服务器装置 10中，由多窗口来执行与来自所述客户机装置 20的事件信号相应的应用程序 (文本制作处理程序、Web浏览器程序、表计算处理程序、邮件处理程序等 )从而进行处理，将伴随该处理所生成的显示用画面数据作为画面更新数据，在每次进行描绘更新时传输至客户机装置 20，使客户机装置 20的显示装置进行画面显示。
次に、リモコン4または操作部から操作受付部64を介して入力される表示モードの切替指令に基づいて、表示モードが、1画面表示モードから履歴映像表示モードに切替わると、第1スケーリング部42は、入力端子Input1が入力する映像信号（DVI信号）に、解像度変換処理を施すことによって、メインウィンドウの表示サイズに相当する解像度を有する表示用の映像を表す映像データを生成する。	接着，基于从遥控器 4或操作部经由操作接受部 64而输入的显示模式的切换指令，当显示模式从 1画面显示模式切换为历史影像显示模式时，第一尺度转换部 42就会通过对输入端子 Input1输入的影像信号 (DVI信号 )实施分辨率转换处理，来生成表示具有相当于主窗口的显示尺寸的分辨率的显示用的影像的影像数据。
【図3】信号のサンプルに対するウィンドウ化処理のブロック図	图 3示出了所采集信号的加窗过程的框图。
たとえば、サブウィンドウ106には、入力端子Input2（HDMI端子）からの映像信号が表示され、サブウィンドウ104には、入力端子Input4（Video端子）からの映像信号が表示され、サブウィンドウ102には、入力端子Input1（DVI端子）からの映像信号が表示されていると想定する。	例如，假设在子窗口 106中显示来自输入端子Input2(HDMI端子 )的影像信号，在子窗口 104中显示来自输入端子 Input4(Video端子 )的影像信号，在子窗口 102中显示来自输入端子 Input1(DVI端子 )的影像信号。
水平ノイズ処理回路513では、垂直検出ウィンドウ信号（VWDET）と水平検出ウィンドウ信号（HWIN）で定められた列オフセット検出期間（検出領域）内で、これらの動作が水平画素毎に順次行われる。	水平噪声处理电路 513在由垂直检测窗信号 (VWDET)和水平检测窗信号 (HWIN)指定的列偏移检测期间 (检测区域 )内对各个水平像素顺序地执行这些操作。
巡回積分回路では、垂直検出ウィンドウ信号（VWDET）と水平検出ウィンドウ信号（HWIN）で定められた列オフセット検出期間（検出領域）内で、これらの動作が水平画素毎に順次行われる。	循环积分电路在由垂直检测窗信号 (VWDET)和水平检测窗信号 (HWIN)指定的列偏移检测期间 (检测区域 )内对各水平像素顺序地执行这些操作。
なお、メインウィンドウ100およびサブウィンドウ102〜106には、映像信号に基づく映像とともに、後述するOSD機能によって、該映像信号に対応する「入力端子名」を重畳して表示させる。	再有，在主窗口 100及子窗口 102～ 106中，与基于影像信号的影像一起，通过后述的 OSD功能，重叠显示对应该影像信号的“输入端子名称”。
このとき、サブウィンドウ102〜106では、上述した入力映像信号の切替えに伴なって、各ウィンドウに表示される履歴映像が更新される。	此时，在子窗口 102～ 106中，随着上述的输入影像信号的切换，更新在各窗口中显示的历史影像。
これにより、スクリーンSCでは、メインウィンドウに入力端子Input1からの映像信号による映像が表示されるとともに、3個のサブウィンドウの各々には履歴映像が表示される。	由此，在屏幕 SC中，在主窗口显示根据来自输入端子 Input1的影像信号而产生的影像，同时还在 3个子窗口中分别显示历史影像。
ウィンドウ回路109は、HD信号及びVD信号を参照して、列オフセット検出回路108にVOB領域における列オフセットの垂直検出期間（垂直検出領域）を指示する垂直検出ウィンドウ信号（VWDET）と水平検出期間（水平検出領域）を指示する水平検出ウィンドウ信号（HWIN）を供給する。	窗电路 109参考 HD信号和 VD信号，将用于指定 VOB区域中的列偏移的垂直检测期间 (垂直检测区域 )的垂直检测窗信号 (VWDET)和用于指定水平检测期间 (水平检测区域 )的水平检测窗信号 (HWIN)提供给列偏移检测电路 108。
たとえば、ウィンドウ206には、入力端子に映像信号が入力されていないことを示す「無信号画面」が表示され、ウィンドウ205には、入力端子Input1（DVI端子）の入力映像信号が表示され、ウィンドウ204には、入力端子Input3（RGB端子）の入力映像信号が表示されていると想定する。	例如，假设在窗口 206中显示表示没有向输入端子输入影像信号的“无信号画面”，在窗口 205中显示输入端子 Input1(DVI端子 )的输入影像信号，在窗口 204中显示输入端子 Input3(RGB端子 )的输入影像信号。
また、ウィンドウ203には、入力端子Input2（HDMI端子）の入力映像信号による映像が表示され、ウィンドウ202には、入力端子Input4（Video端子）の入力映像信号による映像が表示され、ウィンドウ201には、入力端子Inpu1（DVI端子）の入力映像信号による映像が表示されていると想定する。	此外，假设在窗口 203中显示根据输入端子 Input2(HDMI端子 )的输入影像信号而产生的影像，在窗口 202中显示根据输入端子 Input4(Video端子 )的输入影像信号而产生的影像，在窗口 201中显示根据输入端子Input1(DVI端子 )的输入影像信号而产生的影像。
ウィンドウ回路109は、列オフセット検出回路108及び列オフセット除去回路111を駆動する制御信号を生成する。	窗电路 (windowcircuit)109产生驱动列偏移检测电路 108和列偏移去除电路 111所需的控制信号。
メインウィンドウ100には、現在選択されている映像信号に基づく映像（以下、「入力映像」ともいう）が表示される。	在主窗口 100中，显示基于当前选择的影像信号的影像 (以下也称为“输入影像”)。
一例として、メインウィンドウ100には、入力端子Input3（RGB端子）に対応する映像信号による映像が表示されていると想定する。	作为一例，假设在主窗口 100中显示根据与输入端子 Input3(RGB端子 )对应的影像信号而产生的影像。
サブウィンドウ102〜104には、過去に選択された映像信号に基づく映像である履歴映像が表示される。	在子窗口 102～ 104中，显示基于过去选择的影像信号的影像即历史影像。
そして、選択された入力端子からの映像信号による映像を、入力映像としてメインウィンドウ100に表示させる。	然后，在主窗口 100中显示根据来自选择出的输入端子的影像信号而产生的影像作为输入影像。
これにより、図3（b）に示すように、入力端子Input1（DVI端子）からの映像信号による映像がメインウィンドウ100に表示される。	由此，如图 3(b)所示，在主窗口 100中显示根据来自输入端子 Input1(DVI端子 )的影像信号而产生的影像。
これにより、図3で説明したように、入力端子Input2からの映像信号による映像がメインウィンドウに表示される。	由此，如图 3所说明的，在主窗口中显示根据来自输入端子 Input2的影像信号而产生的影像。
タイムウィンドウ上で前記パルス発生器出力信号に対してのパルス周波数計量を計算すること；	计算所述脉冲产生器输出信号在时间窗上的脉冲频率度量；
周波数領域における、ウィンドウの二次ローブは、出力信号y［n］の周波数形状を規定する。	该窗在频域中的副瓣将决定 y[n]输出信号的频率形式。
非対称ウィンドウ1102及び1202の周波数応答は、図11と図12に参照数字1104及び1204で示されたものと同一であるが、ウィンドウが、音声ブロックのほとんど別々の部分で動作するので、ウィンドウ処理の結果は、正弦波でない音声信号に様々なスペクトル特性を有する。	非对称窗口 1102、1202的频率响应相同，如图 11和图 12附图标记 1104和 1204处所示，但是因为窗口作用于音频块的大部分不同的部分上，因此加窗的结果对于不是正弦曲线的音频信号具有不同的频谱特性。
従って、コンポジット信号が送信された場合に、各個別信号が、各APにおいて、それぞれのタイミング・ウィンドウの間に受信されるように、コンポジット信号を備える信号の各々は、時間調整されうる。	由此，就可以对包括复合信号的每一个信号进行时间调整，以使得在发送复合信号时，每个 AP都在其各自的时间窗口接收每个单独信号。
また、ウィンドウ201〜206には、上述したOSD機能によって、映像信号に基づく映像とともに、該映像信号に対応する「入力端子名」が重畳して表示されている。	此外，在窗口 201～ 206中，根据上述的 OSD功能，与基于影像信号的影像一起，重叠显示与该影像信号对应的“输入端子名称”。
処理ユニット417は、例えば、ウィンドウイング及び／あるいは巡回プレフィックス挿入のような追加の信号処理を、時間領域信号S’（t）に対して実行するように構成されうる。	处理单元 417用于对时域信号 S’(t)执行额外的信号处理，诸如，比方说，加窗和 /或循环前缀插入。
処理ユニット607a乃至607nは、例えば、ウィンドウイング及び／あるいは巡回プレフィックス挿入のような追加の信号処理を、持間領域信号S1（t）乃至SN（t）に実行するように構成されうる。	处理单元 607a-607n用于对时域信号 S1(t)到 SN(t)执行额外的信号处理，诸如，比方说，加窗和 /或循环前缀插入。
各APが同じ時間にスケジュールされたタイミング・ウィンドウを有している実施形態において、各個別信号は、各APにおいて同じ時間に受信されるように時間調整される。	在每个AP都将其时间窗口安排在相同的时间的实施例中，每个单独信号都在时间上受到调整，从而使得每个 AP在相同的时间接收每个单独信号。
1 プロジェクタ、3A，3B 通信ケーブル、4 リモコン、7A，7B 伝送路、9 入力部、11〜14 入力端子、21 DVIレシーバ、22 HDMIレシーバ、23 A／Dコンバータ、24 Videoデコーダ、30 入力選択部、31〜34 入力部、35 切替入力部、36，37 出力端子、40 メモリ、42，44 スケーリング部、46 映像信号処理部、48 OSDメモリ、50 液晶表示駆動部、52 光学系、60 制御部、62 保存部、64 操作受付部、100 メインウィンドウ、102，104，106 サブウィンドウ、201〜206 ウィンドウ、400 通常映像表示用メモリ領域、401〜40n 履歴映像用メモリ領域、SC スクリーン。	1 投影机，3A、3B 通信电缆，4 遥控器，7A、7B 传输线路，9 输入部，11～ 14 输入端子，21 DVI接收机，22 HDMI接收机，23 A/D转换器，24 Video解码器，30 输入选择部，31～ 34 输入部，35 切换输入部，36、37 输出端子，40 存储器，42、44 尺度转换 (scaling)部，46 影像信号处理部，48 OSD存储器，50 液晶显示驱动部，52 光学系统，60 控制部，62 保存部，64 操作接受部，100 主窗口，102、104、106 子窗口，201～ 206 窗口，400 常规影像显示用存储器区域，401～ 40n 历史影像用存储器区域，SC 屏幕
具体的には、図3（b）に示すように、サブウィンドウ106には、切替え直前に選択されていた入力端子Input3（RGB端子）に対応する映像信号による映像が、履歴映像3として表示される。	具体地，如图 3(b)所示，在子窗口 106中，显示根据与切换前选择出的输入端子Input3(RGB端子 )对应的影像信号而产生的影像作为历史影像 3。
第2スケーリング部44は、履歴映像表示モードでのサブウィンドウ（図3）の表示サイズに応じて、映像信号の表す映像の解像度の変換処理を実行する。	第二尺度转换部 44，按照历史影像显示模式中的子窗口 (图 3)的显示尺寸，执行影像信号所表示的影像的分辨率的转换处理。
その他の実施形態において、各特定の受信機を宛先にされた信号の一部分は、各特定の受信機のタイミング・ウィンドウの間に届く。	在其它实施例中，发往每个特定接收机的信号部分在每个特定接收机的时间窗口期间到达。
その他の実施形態において、各信号S1（t）乃至SN（t）が、受信機のタイミング・ウィンドウ内に（例えばAP1乃至APNのような）宛先に指定された受信機に届くように、Δ1乃至ΔNの各々は設定されうる。	在其它实施例中，对Δ1到ΔN中的每个进行设置，以使得每个信号 S1(t)到 SN(t)在接收机的时间窗口内到达预定的接收机 (例如，AP1到 APN)。
別の実施形態において、各特定の受信機を宛先にされた信号の一部分が、各特定の受信機のタイミング・ウィンドウの間に届く。	在其它实施例中，发往每个特定接收机的信号部分在每个特定接收机的时间窗口期间到达。
例えば、OSD部136は、表示ウィンドウサイズとエンコードビットレートとの対応関係（プロファイル）の設定時に、設定用のUI（User Interface）画面を表示するための表示信号を発生する。	例如，当设定显示窗口的大小与编码比特率之间的对应关系 (配置特性 )时，OSD单元 136生成用于显示设定 UI(用户界面 )画面的显示信号。
このような表示ウィンドウサイズとエンコードビットレートとの対応関係（プロファイル）の設定時に、制御部131の制御により、OSD部136では、設定用のUI画面を表示するための表示信号が発生される。	当显示窗口的大小与编码比特率之间的对应关系 (配置特性 )被设定时，OSD单元 136在控制单元 131的控制下生成用于显示设定 UI画面的显示信号。
その他の実施形態において、S1（t）乃至SN（t）の各々が、受信機のタイミング・ウィンドウ内に、（例えば、AP1乃至APNのような）宛先に指定された受信機に届くように、Δ1乃至ΔNの各々は設定される。	在其它实施例中，对Δ1到ΔN中的每个进行设置，以使得每个信号 S1(t)到 SN(t)在接收机的时间窗口内到达预定的接收机 (例如，AP1到 APN)。
およびパルスプロセッサ、前記パルス発生器の前記出力信号に結合された前記パルスプロセッサへの入力信号、タイムウィンドウ上で前記パルス発生器出力信号に対してのパルス周波数計量を計算し、第1の蓄積された計量を生成するために複数のタイムウィンドウ上で前記パルス周波数計量を蓄積し、そして、前記第1の蓄積された計量が第1のしきい値を超えたら第1のジャマー検出信号を発生するように構成された前記パルスプロセッサ。	以及脉冲处理器，所述脉冲处理器的输入信号耦合到所述脉冲产生器的所述输出信号，所述脉冲处理器经配置以计算所述脉冲产生器输出信号在时间窗上的脉冲频率度量、累加多个时间窗上的所述脉冲频率度量以产生第一累加度量，且在所述第一累加度量超过第一阈值时产生第一干扰检测信号。
第2スケーリング部44は、入力端子11が入力する映像信号（DVI信号）に、解像度変換処理を施すことによって、サブウィンドウの表示サイズに相当する解像度を有する履歴映像を表す映像データを生成する。	第二尺度转换部 44通过对输入端子 11输入的影像信号 (DVI信号 )实施分辨率转换处理，来生成表示具有相当于子窗口的显示尺寸的分辨率的历史影像的影像数据。
第2スケーリング部44は、入力端子12が入力する映像信号（HDMI信号）に、解像度変換処理を施すことによって、サブウィンドウの表示サイズに相当する解像度を有する履歴映像を表す映像データを生成する。	第二尺度转换部 44，通过对输入端子 12输入的影像信号 (HDMI信号 )实施分辨率转换处理，来生成表示具有相当于子窗口的显示尺寸的分辨率的历史影像的影像数据。
第2スケーリング部44は、入力端子Input1（DVI端子）が入力する映像信号（DVI信号）に、解像度変換処理を施すことによって、ウィンドウ（図7）の表示サイズに相当する解像度を有する履歴映像を表す映像データを生成する。	第二尺度转换部 44通过对输入端子 Input1(DVI端子 )输入的影像信号 (DVI信号 )实施分辨率转换处理，来生成表示具有相当于窗口 (图 7)的显示尺寸的分辨率的历史影像的影像数据。
次に、リモコン4または操作部から操作受付部64を介して入力される表示モードの切替指令に基づいて、表示モードが、1画面表示モードから履歴映像表示モードに切替わると、第1スケーリング部42は、入力端子Input1が入力する映像信号（DVI信号）に、解像度変換処理を施すことによって、メインウィンドウの表示サイズに相当する解像度を有する表示用の映像を表す映像データを生成する。	接着，基于从遥控器 4或操作部经由操作接受部 64而输入的显示模式的切换指令，当显示模式从 1画面显示模式切换为历史影像显示模式时，第一尺度转换部 42就会通过对输入端子 Input1输入的影像信号 (DVI信号 )实施分辨率转换处理，来生成表示具有相当于主窗口的显示尺寸的分辨率的显示用的影像的影像数据。
そして、サーバ装置10では、前記クライアント装置20からのイベント信号に応じたアプリケーションプログラム（テキスト作成処理プログラム，Webブラウザプログラム，表計算処理プログラム，メール処理プログラム，等）をマルチウィンドウにより実行させて処理を行い、この処理に伴って生成された表示用の画面データを画面更新情報として、その描画更新の都度、クライアント装置20へ転送して、クライアント装置20の表示装置に画面表示させる。	然后，在服务器装置 10中，由多窗口来执行与来自所述客户机装置 20的事件信号相应的应用程序 (文本制作处理程序、Web浏览器程序、表计算处理程序、邮件处理程序等 )从而进行处理，将伴随该处理所生成的显示用画面数据作为画面更新数据，在每次进行描绘更新时传输至客户机装置 20，使客户机装置 20的显示装置进行画面显示。
さらに、非アクティブ状態のウィンドウにおいて名前属性が変更になっていた場合には、当該ウィンドウがアクティブ状態になった際にウィンドウ領域のデータをキャプチャすることで、より直近のウィンドウ状態に近いキャプチャデータを取得することができる。	再有，在非激活状态的窗口中名称属性发生变更的情况下，该窗口变为激活状态时通过捕获窗口区域的数据，从而能够取得更接近于当前的窗口状态的捕获数据。
即ち、表示コマンドを受信した場合には、受信したウィンドウIDを持つウィンドウ（アプリケーションプログラム）に対し、activeコマンドを発行することで、当該ウィンドウをアクティブ状態にする（ステップS13B4）。	也就是说，在接收到显示指令的情况下，对具有接收到的窗口 ID的窗口 (应用程序 )发布 active指令，从而使该窗口处于激活状态 (步骤 S13B4)。
また、前記ROM23にはさらに、サーバ装置10のウィンドウ監視マネージャ13A及びウィンドウ制御マネージャ13Bとの通信を行うためのプログラムが記憶され、前記RAM24にはさらに、サーバ装置10のウィンドウ状態を保管するためのウィンドウ制御テーブル24Aなどが記憶される。	此外，所述 ROM23中还存储着用于与服务器装置 10的窗口监视管理器 13A以及窗口控制管理器 13B进行通信的程序，在所述 RAM24中还存储着用于管理服务器装置 10的窗口状态的窗口控制表 24A等。
なおこの場合、キャプチャデータは使用せず、ウィンドウ一覧領域26A2におけるウィンドウの名前の選択イコール当該ウィンドウをアクティブ状態にする指示として、当該名前に対応するウィンドウIDをウィンドウ制御テーブル24Aから取得し、表示コマンドと共に通信I／F28によりサーバ装置10へ送信することとなる。	在这种情况下，不使用捕获数据，作为从窗口一览显示 26A2中选择窗口名称并使该窗口处于激活状态的指示，从窗口控制表 24A取得与该名称相对应的窗口 ID，并与显示指令一起通过通信 I/F28发送至服务器装置 10。
即ち、『表示』ボタンが操作されると、選択状態にある名前のウィンドウをアクティブにする指示であるとして、選択状態の名前に対応するウィンドウIDをウィンドウ制御テーブル24Aから取得し、表示コマンドと共に通信I／F28によりサーバ装置10へ送信する（ステップS243）。	也就是说，当“显示”按钮被操作时，作为是使名称处于选择状态的窗口激活的指示，从窗口控制表 24A取得对应选择状态的名称的窗口 ID，与显示指令一起通过通信 I/F28发送至服务器装置 10(步骤 S243)。
また、『閉じる』ボタンが操作されると、選択状態にある名前のウィンドウを消去する指示であるとして、選択状態の名前に対応するウィンドウIDをウィンドウ制御テーブル24Aから取得し、閉じるコマンドと共に通信I／F28によりサーバ装置10へ送信する（ステップS244）。	此外，当“关闭”按钮被操作时，作为是使名称处于选择状态的窗口消除的指示，从窗口控制表 24A取得对应选择状态的名称的窗口 ID，与关闭指令一起通过通信 I/F28发送至服务器装置 10(步骤 S244)。
また、アクティブ状態のウィンドウが変更した場合（アクティブ変更）には、アクティブになったウィンドウのウィンドウIDと領域をシステムプログラム又はアプリケーションプログラムより取得して（ステップS13A10）、それらの情報をアクティブウィンドウ変更を示す制御用データと共に通信I／F19によりクライアント装置20に送信する（ステップS13A11）。	此外，在激活状态的窗口变更了的情况下 (激活变更 )，由系统程序或应用程序取得处于激活的窗口的窗口 ID和区域 (步骤 S13A10)，通过通信 I/F19将这些信息与表示激活窗口变更的控制用数据一起发送至客户机装置 20(步骤 S13A11)。
このウィンドウ制御ダイアログ26Aでは、その上部のウィンドウ一覧領域26A2に、ウィンドウ制御テーブル24Aの各行の「名前」に登録されている名前に基づいて、サーバ装置10で起動しているウィンドウの名前をタブの形態で一覧表示すると共に、「キャプチャデータ保管場所」でアドレス値が示されているRAM24に保管されている選択状態にある名前のウィンドウのキャプチャデータをプレビュー領域26A3に拡大表示するものである。	在该窗口控制对话框 26A中，在其上部的窗口列表区域 26A2中，根据登记在窗口控制表 24A各行的“名称”中的名称，以标签的形式一览显示服务器装置 10所启动着的窗口的名称，并且在预览区域 26A3放大显示“捕获数据保管位置”中地址值所表示的 RAM24中保管的、名称处于选择状态的窗口的捕获数据。
例えば、アプリケーションプログラムとしてWebブラウザでは、そのウィンドウが非アクティブな状態であっても、自動的に別のWebページに移動するような場合があり、そのような場合には名前属性が変更される。	例如，作为应用程序在 Web浏览器中，即便其窗口是非激活状态，也存在自动转移至其他 Web页面的情况，在这种情况下名称属性被变更。
該効果確認ウィンドウ603への表示としては、スライドバー602が右端に設定された状態、すなわち本実施形態の回復処理を行った結果の表示をデフォルトとする。	假设效果查看窗口 603显示在默认状态下滑动条 602被设置在右端的状态，即通过执行本实施例中的恢复处理而获得的结果。
この例では、ウェイクアップモジュール44は、11．25msのページスキャンウィンドウの間にページスキャンを実行するために、1．28秒ごとに受信機30およびモデムプロセッサ35をスリープ状態から周期的に起動する。	在这个例子中，唤醒模块 44周期性地将接收机 30和调制解调处理器 35从睡眠状态中每隔 1.28秒唤醒，以便在 11.25毫秒的寻呼扫描窗口内执行寻呼扫描。
また、その内のユーザが選択したウィンドウの名前、即ち「アクティブフラグ」が「1」にセットされている名前を選択状態（強調表示）にすると共に、「キャプチャデータ保管場所」に記述されたアドレス値に保管されているキャプチャデータを、「Preview」領域にプレビュー表示する。	此外，其中使用户所选择的窗口名称、即“激活标记”被置为“1”的名称处于选择状态 (着重显示 )，并且将在“捕获数据保管位置”记述的地址值处所保管的捕获数据预览显示在“Preview”区域。
なお、このウィンドウ制御ダイアログ26Aにおいて、一覧表示された名前の選択状態は入力装置17のユーザ操作により変更でき、その変更に応じて「Preview」領域にプレビュー表示されるキャプチャデータが変化する。	此外，在该窗口控制对话框 26A中，一览显示的名称的选择状态能够由输入装置17的用户操作来变更，根据其变更，在“Preview”区域进行预览显示的捕获数据发生变化。
上記で説明したように、ウェイクアップモジュール44は、周期的に、たとえば、11．25msのページスキャンウィンドウの間に1．28秒ごとに1回、ページスキャンを実行するために受信機30およびモデムプロセッサ35をスリープ状態から起動することができる。	如上所讨论地，唤醒模块 44可以周期性地将接收机 30和调制解调处理器 35从睡眠状态中唤醒，以便，例如每隔 1.28秒一次地在 11.25毫秒的寻呼扫描窗口内，来执行寻呼扫描。
基地局102は、任意のオペレーティング・システム、たとえばマイクロソフト・ウィンドウズ（登録商標）、ユニックス、またはリナックスなどを実施しても良い。	基站 102可以实现任何操作系统，诸如微软 Windows、UNIX或 LINUX。
別の例として、ネットワーク機器（110）は、ワシントン州レッドモンドのマイクロソフト社が提供しているマイクロソフト・ウィンドウズ(登録商標)・ネットワークなど利用可能な1つ以上のネットワーク管理プロトコルのネットワーク管理機能性を実装しているドメインコントローラーであり得る。	 作为另一示例，联网设备110可以是实现一个或多个网络管理协议的网络管理功能的域控制器，诸如可从华盛顿州雷蒙德市的微软公司购买到的微软Windows网络中的域控制器。
【図19】TCPスライディング・ウィンドウ動作を描いた図である。	图 19示出了 TCP滑动窗口操作。
【図13】MFP操作画面の画像を含むウィンドウの一例を示す図である。	图 13是示出包括MFP操作屏幕的图像的示例性窗口的图示。
即ち、『表示』ボタンが操作されると、選択状態にある名前のウィンドウをアクティブにする指示であるとして、選択状態の名前に対応するウィンドウIDをウィンドウ制御テーブル24Aから取得し、表示コマンドと共に通信I／F28によりサーバ装置10へ送信する（ステップS243）。	也就是说，当“显示”按钮被操作时，作为是使名称处于选择状态的窗口激活的指示，从窗口控制表 24A取得对应选择状态的名称的窗口 ID，与显示指令一起通过通信 I/F28发送至服务器装置 10(步骤 S243)。
また、『閉じる』ボタンが操作されると、選択状態にある名前のウィンドウを消去する指示であるとして、選択状態の名前に対応するウィンドウIDをウィンドウ制御テーブル24Aから取得し、閉じるコマンドと共に通信I／F28によりサーバ装置10へ送信する（ステップS244）。	此外，当“关闭”按钮被操作时，作为是使名称处于选择状态的窗口消除的指示，从窗口控制表 24A取得对应选择状态的名称的窗口 ID，与关闭指令一起通过通信 I/F28发送至服务器装置 10(步骤 S244)。
また、『キャンセル』ボタンが操作された場合には、何も行なわずに、該ウィンドウ制御ダイアログ26Aを閉じて、このウィンドウ制御に係わる動作を終了する。	此外，在“取消”按钮被操作的情况下，不进行任何动作，关闭该窗口控制对话框26A，结束该窗口控制所涉及的动作。
また、前記ROM13にはさらに、クライアント用VRAM上に生成されるクライアント装置毎のイメージを監視することで、起動しているウィンドウに関する情報を取得するためのプログラムであるウィンドウ監視マネージャ13Aと、通信I／F19からのクライアント装置20でのウィンドウ操作入力（入力イベント）の入力操作データに応じてウィンドウ制御を行なうためのプログラムであるウィンドウ制御マネージャ13Bが記憶される。	此外，所述 ROM13中还存储着窗口监视管理器 13A和窗口控制管理器 13B，窗口监视管理器 13A是用于通过监视客户机用 VRAM上生成的每个客户机装置的图片、从而取得与启动着的窗口相关的信息的程序，窗口控制管理器 13B是用于根据来自通信 I/F19的客户机装置 20中的窗口操作输入 (输入事件 )的输入操作数据来进行窗口控制的程序。
水平ノイズ処理回路513では、垂直検出ウィンドウ信号（VWDET）と水平検出ウィンドウ信号（HWIN）で定められた列オフセット検出期間（検出領域）内で、これらの動作が水平画素毎に順次行われる。	水平噪声处理电路 513在由垂直检测窗信号 (VWDET)和水平检测窗信号 (HWIN)指定的列偏移检测期间 (检测区域 )内对各个水平像素顺序地执行这些操作。
巡回積分回路では、垂直検出ウィンドウ信号（VWDET）と水平検出ウィンドウ信号（HWIN）で定められた列オフセット検出期間（検出領域）内で、これらの動作が水平画素毎に順次行われる。	循环积分电路在由垂直检测窗信号 (VWDET)和水平检测窗信号 (HWIN)指定的列偏移检测期间 (检测区域 )内对各水平像素顺序地执行这些操作。
更に、該ウィンドウ制御ダイアログ26Aの下部には、ユーザが操作可能なボタンとして『表示』、『閉じる』、『キャンセル』の各ボタンを表示する。	进而，在该窗口控制对话框 26A的下部，作为用户可操作的按钮而显示“显示”、“关闭”、“取消”的各按钮。
入力装置17で所定のユーザ操作を行なうことにより、該フローチャートに示すようなウィンドウ制御機能を実現するプログラムが起動されると、まず、ウィンドウ制御テーブル24Aのデータを使用して、ウィンドウ制御ダイアログを作成し、表示装置26に全画面表示する（ステップS241）。	在通过由输入装置 17进行规定的用户操作，来启动实现该流程图所示的窗口控制功能的程序时，首先，使用窗口控制表 24A的数据制作窗口控制对话框，在显示装置 26进行全画面显示 (步骤 S241)。
時間ウィンドウはプログラム可能であることで、動作条件およびアプリケーションに応じて柔軟なものとなっている。	时间窗是可编程的，根据操作条件和应用程序提供灵活性。
ここでの“win＿start2”も、「ウィンドウ読み出し」の動作時にされる設定値であり、“1”〜“1079”の間の任意の値が設定される。	这里，值“win_start2”是在“窗口读取”操作被执行时设置的，并且设置了从“1”至“1079”中选出的任意值。
基地局102は、任意のオペレーティング・システム、たとえばマイクロソフト・ウィンドウズ（登録商標）、ユニックス、またはリナックスなどを実施しても良い。	基站 102可以实现任何操作系统，诸如微软 Windows、UNIX或 LINUX。
そして、ウィンドウ制御ダイアログ26A下部の『表示』、『閉じる』、『キャンセル』の何れかのボタンに対するユーザ操作がなされると、どのボタンに対する操作がなされたかを判別して（ステップS242）、対応する動作を行う。	并且，当对窗口控制对话框 26A下部的“显示”、“关闭”、“取消”的任意一个按钮进行了用户操作时，判别是对哪个按钮进行了操作 (步骤 S242)，进行对应的动作。
“win＿start1”とは、画像の一番上からではなく任意の行から読み出しを開始させる「ウィンドウ読み出し」の動作時に選択される設定値であり、“1”〜“1079”の間の任意の値が設定される。	注意，“win_start 1”表示在“窗口读取”操作被执行时选择的设定值，在“窗口读取”操作中，从任意行而非图像的顶部开始读取。 从“1”至“1079”中选择的任意值被设置为值“win_start 1”。
最初、ユーザはユーザ操作部132を構成するマウス等を用いて、図7（b）に示すように、表示ウィンドウのサイズが所定値以下の範囲に、エンコードビットレートが一定の下限値を示す直線L1を引く。	最初，用户拖动用户操作单元 132的鼠标等等以描绘直线 L1，直线 L1指示出在显示窗口的大小等于或小于预定值的范围中编码比特率的给定下限，如图 7B所示。
1 プロジェクタ、3A，3B 通信ケーブル、4 リモコン、7A，7B 伝送路、9 入力部、11〜14 入力端子、21 DVIレシーバ、22 HDMIレシーバ、23 A／Dコンバータ、24 Videoデコーダ、30 入力選択部、31〜34 入力部、35 切替入力部、36，37 出力端子、40 メモリ、42，44 スケーリング部、46 映像信号処理部、48 OSDメモリ、50 液晶表示駆動部、52 光学系、60 制御部、62 保存部、64 操作受付部、100 メインウィンドウ、102，104，106 サブウィンドウ、201〜206 ウィンドウ、400 通常映像表示用メモリ領域、401〜40n 履歴映像用メモリ領域、SC スクリーン。	1 投影机，3A、3B 通信电缆，4 遥控器，7A、7B 传输线路，9 输入部，11～ 14 输入端子，21 DVI接收机，22 HDMI接收机，23 A/D转换器，24 Video解码器，30 输入选择部，31～ 34 输入部，35 切换输入部，36、37 输出端子，40 存储器，42、44 尺度转换 (scaling)部，46 影像信号处理部，48 OSD存储器，50 液晶显示驱动部，52 光学系统，60 控制部，62 保存部，64 操作接受部，100 主窗口，102、104、106 子窗口，201～ 206 窗口，400 常规影像显示用存储器区域，401～ 40n 历史影像用存储器区域，SC 屏幕
ここでの“win＿width”も、「ウィンドウ読み出し」の動作時に設定される読み出す行数を指定するための設定値であり、“1”〜“1080”の間の任意の値が設定される。	注意，“win_width”也表示在“窗口读取”操作被执行时设置的、指定要读取的行的数目的设定值，并且从“1”至“1080”中选择的任意值被设置。
ここでの“win＿width”も、「ウィンドウ読み出し」の動作時に設定される読み出す行数を指定するための設定値であり、“1”〜“1080”の間の任意の値が設定される。	值“1080/win_width”也是在“窗口读取”操作被执行时设置的、用于指定要读取的行的数目的设定值。
例示的な実施形態において、各サブウィンドウの継続時間および対応するしきい値Tsはオペレーションの周波数バンドに依存して決められても構わない。	在一示范性实施例中，可使每一子窗的持续时间和对应阈值 Ts视操作的频带而定。
例えば、450MHzXOでのオペレーションに対しては、各サブウィンドウの継続時間は19．2MHzXO基準クロックの8サイクルでも構わなく、そして、Tsは1でも構わない。	举例来说，对于在 450MHz RX频带中的操作，每一子窗的持续时间可为 8个循环的19.2-MHz XO参考时钟，且 Ts可为 1。
PCS周波数バンドでのオペレーションに対しては、各サブウィンドウの継続時間はTCXO基準クロックの2サイクルでも構わなく、Tsは1でも構わない。	对于在 PCS频带中的操作，每一子窗的持续时间可为2个循环的 TCXO参考时钟，且 Ts可为 1。
【図6】図5に示されている実施例で使用される、本発明に従った送信者電子郵便の電子郵便局「ウィンドウ」または電子郵便ウェブサイトでのインタラクション動作のフローチャートである。	图 6是依照本发明而在图 5所示的实施例中使用并在电子邮局“窗口”或电子邮政网站上执行的发信方电子邮政操作交互的流程图；
【図7】図5に示されている実施例で使用される、本発明に従った受信者電子郵便の電子郵便局「ウィンドウ」または電子郵便ウェブサイトでのインタラクション動作のフローチャートである。	图 7是依照本发明而在图 5所示的实施例中使用并在电子邮局“窗口”或电子邮政网站上执行的收信方电子邮政操作交互的流程图；
-ユーザー自身のメールボックス／電子メールアプリケーションを介してではなく、電子郵便局20の「ウィンドウ（または、窓口）」またはウェブサイトへアクセスする等の、電子郵便局20のアクセスのためのオプションの提供	-提供用于访问电子邮局 20的选项，例如转到电子邮局 20的“窗口”或“网站”，而不是通过自己的邮箱 /电子邮件应用来进行操作
なお、このウィンドウ制御ダイアログ26Aにおいて、一覧表示された名前の選択状態は入力装置17のユーザ操作により変更でき、その変更に応じて「Preview」領域にプレビュー表示されるキャプチャデータが変化する。	此外，在该窗口控制对话框 26A中，一览显示的名称的选择状态能够由输入装置17的用户操作来变更，根据其变更，在“Preview”区域进行预览显示的捕获数据发生变化。
そのため、監視カメラ101-1〜101-6の少なくともいずれかに対応した表示ウィンドウのサイズ変更があった場合に、監視カメラ個々のエンコードビットレートをその変更に合わせて直ちに最適値に変更でき、ユーザの操作手間を軽減できる。	因此，当与监视相机 101-1至 101-6中的至少一个相对应的显示窗口的大小被改变时，各监视相机的编码比特率可以立即响应于显示窗口的大小的变化而被改变到最优值，从而减轻了用户的操作负担。
また、利用者により再生時間指定ボタン622あるいは再生割合指定ボタン623が操作され、モードが変更されたときには、変更される前のモードにおけるパラメタ値から変更した後のモードのパラメタ値に計算しなおして、再生時間／割合指定ウィンドウ621に表示するとよい。	另外，当由利用者操作再现时间指定按钮 622或再现比例指定按钮 623、变更模式时，也可以计算从变更前的模式中的参数值到变更后的模式中的参数值，在再现时间 /比例指定窗口 621中显示出来。
次に、リモコン4または操作部から操作受付部64を介して入力される表示モードの切替指令に基づいて、表示モードが、1画面表示モードから履歴映像表示モードに切替わると、第1スケーリング部42は、入力端子Input1が入力する映像信号（DVI信号）に、解像度変換処理を施すことによって、メインウィンドウの表示サイズに相当する解像度を有する表示用の映像を表す映像データを生成する。	接着，基于从遥控器 4或操作部经由操作接受部 64而输入的显示模式的切换指令，当显示模式从 1画面显示模式切换为历史影像显示模式时，第一尺度转换部 42就会通过对输入端子 Input1输入的影像信号 (DVI信号 )实施分辨率转换处理，来生成表示具有相当于主窗口的显示尺寸的分辨率的显示用的影像的影像数据。
なお、メインウィンドウ100およびサブウィンドウ102〜106のサイズおよび配置、サブウィンドウの個数については、図3の態様に限定されるものではない。	再有，主窗口 100及子窗口 102～ 106的尺寸及配置、子窗口的个数不限于图 3的状态。
なお、ウィンドウ201〜206のサイズおよび配置、ウィンドウの個数については、図7の態様に限定されるものではない。	再有，窗口 201～ 206的尺寸及配置、窗口的个数不限于图 7的样式。
【図13】各監視カメラの表示ウィンドウサイズを設定する際に、対応するプロファイルを表示することを示す図である。	图 13是示出当设定监视相机的显示窗口的大小时的对应配置特性的显示的示图。
制御部131は、各カメラのプロファイルから各カメラの表示ウィンドウサイズに対応したエンコードビットレートを求める。	控制单元 131根据各个相机的配置特性计算各个相机的与显示窗口的大小相对应的编码比特率。
そして、サブウィンドウ102〜106にそれぞれ表示される履歴映像は、時間的に古いもの（図中の履歴映像1に相当）から新しいもの（図中の履歴映像3に相当）の順番に並べて配置されるものとする。	而且，分别在子窗口 102～ 106中显示的历史影像，按从时间老的 (相当于图中的历史影像 1)到新的 (相当于图中的历史影像 3)的顺序排列配置。
例えば、OSD部136は、表示ウィンドウサイズとエンコードビットレートとの対応関係（プロファイル）の設定時に、設定用のUI（User Interface）画面を表示するための表示信号を発生する。	例如，当设定显示窗口的大小与编码比特率之间的对应关系 (配置特性 )时，OSD单元 136生成用于显示设定 UI(用户界面 )画面的显示信号。
このような表示ウィンドウサイズとエンコードビットレートとの対応関係（プロファイル）の設定時に、制御部131の制御により、OSD部136では、設定用のUI画面を表示するための表示信号が発生される。	当显示窗口的大小与编码比特率之间的对应关系 (配置特性 )被设定时，OSD单元 136在控制单元 131的控制下生成用于显示设定 UI画面的显示信号。
監視装置103の制御部131は、上述したように監視カメラ101-1〜101-6のエンコードビットレートの決定を、プロファイル（表示ウィンドウサイズとエンコードビットレートとの対応関係）に基づいて行う。	监视装置 103的控制单元 131基于配置特性 (显示窗口的大小与编码比特率之间的对应关系 )来确定监视相机 101-1至 101-6的编码比特率，如上所述。
このステップST14において、制御部131は、オプション非設定カメラのプロファイルから各カメラの表示ウィンドウサイズに対応したエンコードビットレートを求める。	在步骤 ST14中，控制单元 131根据未设定该选项的相机的配置特性，计算每个相机的与显示窗口的大小相对应的编码比特率。
このステップST16において、制御部131は、オプション設定カメラのプロファイルから、そのカメラの表示ウィンドウサイズに対応したエンコードビットレートを求める。	在步骤 ST16中，控制单元 131根据设定了该选项的相机的配置特性，计算该相机的与显示窗口的大小相对应的编码比特率。
このステップST20において、制御部131は、オプション非設定カメラのプロファイルから各カメラの表示ウィンドウサイズに対応したエンコードビットレートを求める。	在步骤 ST20中，控制单元 131根据未设定该选项的相机的配置特性，计算每个相机的与显示窗口的大小相对应的编码比特率。
ここで、表示ウィンドウサイズをx、エンコードビットレートをyとするとき、カメラ1のプロファイルは、y＝5k＊x（kは定数）の一次関数で表されている。	这里，假定 x是显示窗口的大小，并且 y是编码比特率，则相机 1的配置特性由线性函数 y＝ 5k*x(其中 k是常数 )来表达。
ここで、表示ウィンドウサイズをx、エンコードビットレートをyとするとき、カメラ1のプロファイルは、y＝5k＊x（kは定数）の一次関数で表されている。	这里，假定 x是显示窗口的大小并且 y是编码比特率，则相机 1的配置特性由线性函数 y＝ 5k*x(其中 k是常数 )来表达。
また、図1に示す監視カメラシステム100を構成する監視装置103において、各監視カメラの表示ウィンドウサイズを設定する際、図13に示すように、対応するプロファイルのグラフを表示するようにしてもよい。	当在图 1中的监视相机系统 100的监视装置 103中设定每个监视相机的显示窗口的大小时，可以显示相应配置特性的曲线图，如图 13所示。
可能性のある各カットポイントは、考慮されたカットポイントについてのホライズンウィンドウ内に配置されたハッシュ値を評価することによって評価される。	通过估算位于界限窗口内假想拆分点附近的散列值，可估算每个可能的拆分点。
本変更例では、6個のウィンドウ201〜206は、同じサイズであって、それぞれに表示される履歴映像は、時間的に古いもの（図中の履歴映像1に相当）から新しいもの（図中の履歴映像6に相当）の順番に並べて配置されるものとする。	在本变更例中，6个窗口 201～ 206尺寸相同，各自显示的历史影像按从时间老的 (相当于图中的历史影像 1)到新的 (相当于图中的历史影像 6)的顺序排列配置。
上述したように、図1の監視カメラシステム100を構成する監視装置103において、制御部131は、各監視カメラのエンコードビットレートを、表示ウィンドウサイズとエンコードビットレートとの対応関係（プロファイル）に基づいて決定する。	在图 1中的监视相机系统 100的监视装置 103中，如上所述，控制单元 131基于显示窗口的大小与编码比特率之间的对应关系 (配置特性 )来确定每个监视相机的编码比特率。
およびパルスプロセッサ、前記パルス発生器の前記出力信号に結合された前記パルスプロセッサへの入力信号、タイムウィンドウ上で前記パルス発生器出力信号に対してのパルス周波数計量を計算し、第1の蓄積された計量を生成するために複数のタイムウィンドウ上で前記パルス周波数計量を蓄積し、そして、前記第1の蓄積された計量が第1のしきい値を超えたら第1のジャマー検出信号を発生するように構成された前記パルスプロセッサ。	以及脉冲处理器，所述脉冲处理器的输入信号耦合到所述脉冲产生器的所述输出信号，所述脉冲处理器经配置以计算所述脉冲产生器输出信号在时间窗上的脉冲频率度量、累加多个时间窗上的所述脉冲频率度量以产生第一累加度量，且在所述第一累加度量超过第一阈值时产生第一干扰检测信号。
2以上の整数n個のビューを見るためにn個の一次視点補正されたビューウィンドウを生成するために、該視差光学素子と協働する行および列として配列された複数の画素を備える空間光変調器であって、各ビューウィンドウ内の各視差エレメントを介して見ることのできる画素のそれぞれの単一の列を有し、該画素は、それぞれのカラー画像エレメントを表示するための複合色グループとして配列され、各グループは、互いに同じ列に隣接して配置された3以上の整数x個の異なるカラーのx以上の整数z個の画素を備え、各ビューに対する各カラーの該画素は、実質的に等間隔で水平に、かつ、実質的に等間隔で垂直になるように配置され、各グループの該画素の該カラーの列方向の順番は、同じ行内の隣接する各グループの該画素の該カラーの列方向の順番と異なることを特徴とする、空間光変調器とを備える。	以及空间光调制器，它包括排列成行与列的多个像素，这些像素与视差光学器件相互配合以便为观看 n个视图而产生 n个主视点校正的观看窗口，其中 n是大于 1的整数，透过每个视差元件可以在每个观看窗口中看到各个单列像素，这些像素排列成用于显示各颜色图像元件的复合颜色组，各组包括在同一列中彼此相邻设置的 x种不同颜色的z个像素，其中 x是大于 2的整数，z是大于或等于 x的整数，用于各视图的各种颜色的像素被设置成在水平方向上和垂直方向上都基本上均匀间隔开，其特征在于，每组的像素的颜色在列向上的顺序都不同于同一行中各相邻组的像素的颜色在列向上的顺序。
従って、偏光光と共にDLP装置を適切に用いるための新しいウィンドウパッケージングは有用である。	 因此，为恰当地利用CN  10202774672 AA 说  明  书 8/14页具有偏振光的 DLP装置，新窗口封装将是有用的。
え！	诶！
ええと、そうねえ。	嗯……是啊。
集え。	集合。
ええ、Dante200 です。	好的，Dante200。
ええっと。	嗯。。。那个
言えてる	没错
消えろ。	消失吧。
乗せ替え	换乘
飢え凍える，飢えや寒さをこらえる．	挨饿受冻
震える．	打哆嗦
いいえ！	不价！
すげえや！	镇了！
ええ？何だって？	啊？你说什么？
例えて言えば．	举例［来］说
ええ，すぐ行きます．	呣，我就去。
湘江．	湘水
声が震える．	声音发颤。
甘えた声．	嗲声嗲气
前へならえ！	向前看齐！
苗木を植える．	栽树苗
兵役を終える，労役を終える．	服役期满
永遠の繁栄	永远的繁华
笑顔が絶えない。	笑容不断。
前向きな考え	积极的想法
塩分控えめ	盐分控制
考え込んだ声	沉思的声音
鳥のさえずり声	鸟的叫声
英語で伝える。	用英语表达。
英語を教えて。	教英语。
炎症を抑える。	控制炎症。
使える英語	能用的英语
恩返しの考え．	报恩思想
腕前を鍛える．	练本领
援助を与える．	给予扶持
試練に耐え得る．	经得起考验
腕前を鍛える．	练本领
影響を与える．	施加影响
笑顔で迎える．	笑脸相迎
ええ、構いませんよ。	嗯，不要紧哦。
ええかまいませんよ。	是的，没关系。
えびのマヨネーズ和え	蛋黄酱拌虾
映画の撮影を終える。	电影杀青。
ええかげんにしいや。	随便你怎么样吧。
その服ええやん。	那个衣服不错啊。
教えてもらえますか？	能教给我吗？
迎えに来てもらえますか？	能来接我吗？
1200円	1200日元
家へ	回家
教えてもらえますか？	可以告诉我吗？
君，行くか？—ええ，行きます．	你去吗？—啊，我去。
エアバス．	空中巴士
エアログラム．	航空邮简
エアバス．	空中［公共］汽車
エアポット．	气压暖瓶
エアーブレーキ．	气闸
エアコンをつける。	打开空调。
エアコンがついています。	空调开着。
エアコンをつけます。	我开空调。
エアコンが作動しない。	空调不工作。
エアコンの幅と位置	空调的宽度和位置。
エアコンが効かない。	空调不起作用。
ラムエアタービン．	冲压空气轮机
エアライフルを撃つ．	打气枪
エアコンディショナー．	空气调节器
エアメールを送る．	邮航空信
オンエアマネージャ12aは、オンエアの管理を行う。	实况转播管理器 12a执行实况转播管理。
会社のエアコンが直りました。	公司的空调修好了。
私はエアコンを切りました。	我关掉了空调。
エアコンなしでは過ごせなかった。	曾没有空调不能生活。
エアコンを取り替えてほしい。	想让你帮我换空调。
まだエアコンを買っていません。	我还没有买空调。
バーのエアコンが故障した。	酒吧的空调坏了。
部屋のエアコンをつけます。	打开房间里的空调。
私はエアコンの下にいる。	在空调下面。
エアコンを付けたまま寝た。	我开着空调就睡了。
そのエアコンは直りました。	那个空调修好了。
エアコンの修理をお願いします。	请修理空调。
暑いのでエアコンを付けます。	太热了开空调。
ソフトウエア会社で働いてます。	在软件公司工作。
エアコンをつけてください。	请把空调打开。
エアコンの温度を下げてください。	请降低空调的温度。
図示される様々な要素の機能は、専用のハードウエア、または適切なソフトウエアと共にソフトウエアを実行可能なハードウエアの使用によって提供され得る。	可通过专用硬件以及能够执行软件的硬件的使用结合适当的软件来提供附图中示出的各个元件的功能。
事務所の中はエアコンがきいていてちょうどいい。	办公室中开着空调，温度正好。
暑いので、今日エアコンと扇風機をつけました。	因为很热，今天开了空调和电风扇。
最近は暑いので、エアコンをつけた。	最近很热，所以开了空调。
最近は暑いので、エアコンを運転した。	最近很热，所以开了空调。
エアコンが壊れてるかどうか調べてほしい。	想让你调查一下空调是不是坏了。
あまりの暑さに、エアコンが手放せない。	特别热的时候离不开空调。
車の中はエアコンが調子悪く、とても暑かったです。	车上的空调运转不灵，特别的热。
節約のためエアコンを使わないことにしている。	我决定为了节约而不用空调。
3階にあるエアコンの修理は終わりました。	三楼空调的修理结束了。
エアコンの設定温度を上げてください。	请调高空调设定的温度。
そのエアコンを弱めてもいいですか。	我可以把那个空调调低一点吗？
私の家のエアコンからたくさんの水が落ちてきた。	我家的空调里滴下来很多水。
エアロゾルは冷却塔からあがった。	悬浮微粒从冷却水塔那升起来。
そのエアロックは正常に機能している。	那个气塞运作正常
朝仕事に行く時にエアコンをつけます。	早上去上班的时候打开空调。
このエアコンは修理するより買う方が安いです。	这个空调买新的比修理更便宜。
エアコンが効いた部屋で休んでいた。	我在空调运转很好的房间休息了。
私は先週にエアコンを新たに購入しました。	我上周买了新空调。
エアコンをつける。	打开空调。
エアコンがついています。	空调开着。
エアコンをつけます。	我开空调。
エアコンが作動しない。	空调不工作。
エアコンの幅と位置	空调的宽度和位置。
エアコンが効かない。	空调不起作用。
エアコンディショナー．	空气调节器
会社のエアコンが直りました。	公司的空调修好了。
私はエアコンを切りました。	我关掉了空调。
エアコンなしでは過ごせなかった。	曾没有空调不能生活。
エアコンを取り替えてほしい。	想让你帮我换空调。
まだエアコンを買っていません。	我还没有买空调。
バーのエアコンが故障した。	酒吧的空调坏了。
部屋のエアコンをつけます。	打开房间里的空调。
私はエアコンの下にいる。	在空调下面。
エアコンを付けたまま寝た。	我开着空调就睡了。
そのエアコンは直りました。	那个空调修好了。
エアコンの修理をお願いします。	请修理空调。
暑いのでエアコンを付けます。	太热了开空调。
エアコンをつけてください。	请把空调打开。
エアコンの温度を下げてください。	请降低空调的温度。
事務所の中はエアコンがきいていてちょうどいい。	办公室中开着空调，温度正好。
暑いので、今日エアコンと扇風機をつけました。	因为很热，今天开了空调和电风扇。
最近は暑いので、エアコンをつけた。	最近很热，所以开了空调。
最近は暑いので、エアコンを運転した。	最近很热，所以开了空调。
エアコンが壊れてるかどうか調べてほしい。	想让你调查一下空调是不是坏了。
あまりの暑さに、エアコンが手放せない。	特别热的时候离不开空调。
車の中はエアコンが調子悪く、とても暑かったです。	车上的空调运转不灵，特别的热。
節約のためエアコンを使わないことにしている。	我决定为了节约而不用空调。
3階にあるエアコンの修理は終わりました。	三楼空调的修理结束了。
エアコンの設定温度を上げてください。	请调高空调设定的温度。
そのエアコンを弱めてもいいですか。	我可以把那个空调调低一点吗？
私の家のエアコンからたくさんの水が落ちてきた。	我家的空调里滴下来很多水。
朝仕事に行く時にエアコンをつけます。	早上去上班的时候打开空调。
このエアコンは修理するより買う方が安いです。	这个空调买新的比修理更便宜。
エアコンが効いた部屋で休んでいた。	我在空调运转很好的房间休息了。
私は先週にエアコンを新たに購入しました。	我上周买了新空调。
私は先週にエアコンを新たに買いました。	我上周买了新空调。
今日は朝からずっとエアコンをつけています。	今天从早上开始就一直开着空调。
室内にエアコンが設置してあります。	室内设有空调。
体育館内はエアコンがなく、暑かったです。	体育馆里没有空调，很热。
エアコンの取付位置に注意してください。	请注意空调的安装位置。
スペースが狭いため、小さいエアコンにしてください。	因为空间很小，请选小的空调。
夏になると部屋が暑いのでエアコンをつけます。	到了夏天房间会很热所以会开空调。
節電しなければとは思うものの、エアコンをつけたい。	尽管想着必须省电，但还是想开空调。
寒いのでエアコンをつけてください。	因为很冷请把空调打开。
その電車には、エアコンがついてませんでした。	那个电车没有空调。
その電車には、エアコンが装備されていませんでした。	那个电车没有装空调。
エアコンや自動車などのあらゆる製品の売り上げが急増する。	空调和汽车等各种各样的产品的销售量迅速增加。
私たちはエアコンがないと暑くて寝ることができない。	我们没有空调的话就热得睡不着。
エアコンディショナー．	空气调节器
ラムエアタービン．	冲压空气轮机
エアバス．	空中巴士
エアバス．	空中［公共］汽車
5月3日と4日はは運休の為、エアポート連絡バスも運休です。	5月3日和4日是连休，所以机场大巴也停止运营。
エアメールを送る．	邮航空信
エアライフルを撃つ．	打气枪
（航空会社名・空港や運賃の等級などを示す符号）エアラインコード．	航空代号
エアログラム．	航空邮简
日本に帰ってきた後にエアログラムで手紙を送ります。	我回到日本后用航空邮件寄信。
エアログラム．	航空邮简
日本に帰ってきた後にエアログラムで手紙を送ります。	我回到日本后用航空邮件寄信。
エアーブレーキ．	气闸
一番印象に残っている名所は、エアーズロックです。	影响最深刻的有名景点就是澳洲大红岩。
無線端末は、一般的には、1つ以上の基地局を備えたエアー・インターフェース上で通信する。	无线终端通常经由空中接口与一个或一个以上基站通信；
IEEE 802.16xは、固定式または移動式の広帯域無線アクセス(BWA)システムのためのエアー・インターフェース(air interface)を定義する新興の(emerging)標準機構である。	IEEE 802.16x是为固定和移动宽带无线接入 (BWA)系统定义空中接口的新兴的标准组织。
制御Aをスクランブルするのに使用されるMAC＿IDは、（i）恐らく特別の符号スキームを使用し、234で示されるようにPDCCHA（物理ダウンリンク制御チャネル）を使用して、エアーにより、または（b）236で示されるようなバックホールにより、UEB202に知らせることができる。	可以通过以下方式将用于加扰控制 A的 MAC_ID透露给 UEB 202： (i)如 234所示，在空中，使用 PDCCHA(物理下行链路控制信道 )，可能使用特定的编码方案；
エアーブレーキ．	气闸
英語．	英文
SF映画	科幻电影
映画．	电影儿
いいえ！	不价！
映画界．	影坛
永遠の繁栄	永远的繁华
映画の撮影	电影的拍摄
映画撮影所．	电影制片厂
映画撮影機．	［电影］摄影机
映画の撮影を終える。	电影杀青。
エロ映画，ポルノ映画．	黄色电影
映画を撮影する．	拍摄电影
英雄は英雄を惜しむ．	英雄惜英雄。
愛情映画，恋愛映画．	言情片
映画を3度上映した．	演了三次电影。
101 GPS衛星	101    GPS卫星
映画を撮る	拍电影
上映される	被上映
ばかな映画	无聊的电影
白黒映画	黑白電影
映画を作る。	制作电影。
営業をする。	做销售。
自営業者	自营业者
彼らは声をそろえて「えいえいおう」と叫んだ。	他们齐声喊着“嗨哟嗬”。
営業に行く。	去销售。
影響ない	没影响。
映画の規模	电影的规模
映画をみる。	看电影。
映画を観た。	观赏了电影。
永遠の友	永远的朋友
永遠の恋	永远的爱恋
英語に訳す。	译成英语。
英語を学ぶ。	学习英语。
英語を話す。	说英语。
英語苦手。	英语不好。
英文追加	英语添加
基礎英語	基础英语
最新鋭の	最新锐利的
映画を見た。	我看了电影。
水泳プール．	游泳池
長編映画．	大型影片
航行衛星．	导航卫星
テレビ映画．	电视电影
映画を見る．	看电影
カラー映画．	彩色电影
映画スター．	电影明星
映画の切符．	电影票
映画俳優．	电影演员
映画週間．	电影周
防衛措置．	防卫措施
ベストエイト．	前八名
シビレエイ．	电鳐
エイプリルフール．	愚人节
 313 送信ウエイト制御部；	313发送加权控制单元；
バンドエイドを貼っている。	我贴着创口贴。
エイズが治る事を信じている。	我相信艾滋会被治愈。
私はバンドエイドを貼っている。	我在贴邦迪创可贴。
エイズは血液由来の病気だ。	艾滋病是血液传播的疾病。
ウエイト計算部44は、LMSアルゴリズムを実行することによって、受信ウエイトベクトルを導出する。	权重计算部 44通过执行 LMS算法导出接收权重向量。
ウエイト計算部44は、受信ウエイトベクトルを乗算部40へ出力する。	权重计算部 44将接收权重向量输出至乘法部 40。
ウエイトレスとして働きたくない。	我不想作为一个女服务生工作。
エイミーは次に何をすべきだと思いますか。	艾米，你觉得接下来应该做什么呢？
エイミーは次に何をすべきだと思いますか？	艾米觉得下一步该做什么？
私はエイムスのひそみに倣ってそう言った。	我說,盲目的追崇著AMIS
その歌手はティーンエイジャーに人気がある。	那个歌手在青少年中很有人气。
大頭のエイリアンが宇宙船から出てきた。	大脑袋的外星人走出了宇宙飞船。
このアフィリエイトは儲かるのでしょうか？	这个分支机构赚钱吗？
最近エイジングケアが気になってきた。	最近开始重视防衰老护理了。
ウエイターが熱い皿のスープを出した。	服务员端出了热汤。
我々はエイトオールまで試合を進めた．	我们打到八平。
エイズは彼の生命を奪って行った．	艾滋病夺去了他的生命。
企業がクリエイターの人材不足に悩まされている一方で、なかなか就職できないクリエイターが多い。	一方面企业苦恼创造者的人才不足，另一方面还有很多的创造者不能就业。
企業がクリエイターの人材不足に悩まされている一方で、なかなか就職できないクリエイターが多い。	一方面企业很烦恼创造者人才不足，另一方面有很多不能就业的创造者。
【図5】デジタル信号及びそのエイリアスを説明する図を示す。	图 5示出了图示数字信号及其假信号 (alias)的示图，
クリエイターの物を創る時の彼らの優しい目つきが良いよね。	他们在创造东西的时候，温柔的眼神真的很美好呢。
ニューモシスティス肺炎はエイズ患者によく見られる。	肺孢子菌肺炎在艾滋病患者中很常见。
友達と良いエイプリルフールを過ごした人を知っています。	知道朋友和度过一个好的愚人节的人。
虫のようなエイリアンが宇宙船から降りてきた。	长得像虫一样的外星人从宇宙飞船里下来了。
私が店に入ったとき、ウエイターがカウンターをふいていた。	在我进入店里的时候，服务员正在擦柜台。
指定ジョブがウエイト／プルーフモードのジョブであることを判別した場合は、ステップST15に移行してウエイトモードや、プルーフモード、用紙予約等に対応したウエイト／プルーフモード（Wait／Proof Mode）表示処理を実行する。	在判别为指定作业为等待 /验证模式的作业的情况下，转移至步骤 ST15并执行与等待模式、验证模式、用纸预约等对应的等待 /验证模式 (Wait/Proof Mode)显示处理。
そして、画像制御CPU5は、登録されたジョブに、ウエイトモードや、プルーフモード、用紙予約等が設定されていると判別した場合は、ステップST3に移行してウエイトモードや、プルーフモード、用紙予約等に対応したウエイト／プルーフモード（Wait／Proof Mode）表示処理を実行する。	然后，图像控制 CPU5在判定为被注册了的作业中，设定了等待模式、验证模式、用纸预约等的情况下，转移至步骤 ST3并执行与等待模式、验证模式、用纸预约等对应的等待 /验证模式 (Wait/Proof Mode)显示处理。
受信ウエイトベクトルの計算には、適応アルゴリズム、例えば、LMSアルゴリズムが使用される。	接收权重向量的计算中使用自适应算法，例如采用 LMS算法。
処理部16は、グループ内のデータを使用して受信ウエイトベクトルを導出する（S16）。	处理部 16使用组内的数据导出接收权重向量 (S 16)。
処理部16は、グループ内のデータを使用して受信ウエイトベクトルを導出する（S56）。	处理部 16使用组内的数据导出接收权重向量 (S56)。
【図16】ウエイト／プルーフモード等の予約ジョブの表示制御例を示すフローチャートである。	图 16是表示等待 /验证模式等的预约作业的显示控制例子的流程图。
このエイリアシングは、受信機における信号の品質を低下させる可能性がある。	此混叠会使接收机处的信号质量降级。
アンチエイリアシングフィルタは約700KHzの出力帯域幅を有することができる。	抗混叠滤波器可以具有约为 700KHz的输出带宽。
広告業者は消費者の注目を集めるためにさまざまなクリエイティブ戦略を使う。	广告公司为了吸引消费者的关注使用各种创意战略。
受信装置は、グループ単位に共通の受信ウエイトベクトルを生成し、生成した受信ウエイトベクトルにてアダプティブアレイ信号処理を実行する。	接收装置以组单位生成共同的接收权重向量，由生成的接收权重向量执行自适应阵列信号处理。
データ数が少ない場合に、このようなデータを使用して受信ウエイトベクトルを導出すると、受信ウエイトベクトルの精度が低下するおそれがある。	数据数目较少的情况下，当使用这种数据导出接收权重向量时，接收权重向量的精度有可能下降。
ウエイト／プルーフモード等の予約ジョブが先頭ジョブの位置となっている場合は、ステップST22でウエイト／プルーフモードの表示処理を実行する。	在等待 /验证模式等的预约作业成为开头作业的位置的情况下，在步骤 ST22中执行等待 /验证模式的显示处理。
上述のステップST21でウエイト／プルーフモード等の予約ジョブが、先頭ジョブに至っていないと判別した場合は、ステップST23に移行してウエイト／プルーフ識別表示処理を実行する。	在上述步骤 ST21中，判定为等待 /验证模式等的预约作业没有达到开头作业的情况下，转移至步骤 ST23并执行等待 /验证识别显示处理。
ベースバンド増幅器1025a／1025bの増幅された出力信号は、次いで、アナログデジタル変換の前にエイリアシング成分を除去するために、アンチエイリアシングフィルタ1032a／1032bによってフィルタ処理される。	基带放大器 1025a/1025b的经放大的输出信号然后由抗混叠滤波器 1032a/1032b进行滤波，以在模数转换之前去除混叠分量。
第2のアンチエイリアシングフィルタ1430は、デシメータ1440によるデシメーションの前に、16MHzのサンプリングレートのためにエイリアシング成分をフィルタ除去するように構成できる。	第二抗混叠滤波器 1430可以配置为在抽取器 1440进行抽取之前针对 16MHz的采样率滤除混叠分量。
10 アンテナ、 12 RF部、 14 分割部、 16 処理部、 18 合成部、 20 測定部、 22 制御部、 24 決定部、 40 乗算部、 42 加算部、 44 ウエイト計算部、 100 受信装置。	16-处理部； 18-合成部；
アダプティブアレイ信号処理は、受信ウエイトベクトルによって、入力ベクトルを重みづけした後に、それらを合成する。	自适应阵列信号处理由接收权重向量对输入向量进行加权之后，将他们进行合成。
また、乗算部40は、受信ウエイトベクトルによって入力ベクトルを重みづけた後、加算部42へ出力する。	此外，乘法部 40由接收权重向量对输入向量进行加权之后，输出至加法部 42。
図中、Tは出力時間を示しており、ウエイトモードの予約ジョブのジョブ開始の予想時刻13時47分を示している。	 在图中，T表示输出时间，表示等待模式的预约作业的作业开始的预计时刻 13时 47分。
また、図10Cに示す出力モードの記述欄においては、例えば、通常出力、ウエイトモード（Wait Mode）プルーフモード（Proof Mode）が記述される。	此外，在图 10的 (C)所示的输出模式的记述栏中，例如，被记述了通常输出、等待模式 (Wait Mode)、验证模式 (ProofMode)。
その後、ステップST14で、画像制御CPU5は、指定ジョブがウエイト／プルーフモード又は通常の動作モードかを判別する。	 然后，在步骤 ST14中，图像控制 CPU5判别指定作业是等待 /验证模式或是通常的动作模式。
いいと思う。	我觉得很好。
いいセンスだ。	品味很好。
いいと思います。	我觉得很好。
いってらしゃい。	你走好。
いつがいいですか？	什么时间好？
あなたは格好いい。	你很帅。
いい人生を送っている。	我过得很好。
いつも元気です。	我一直都很好。
いつも寝起きが良い。	我起床的习惯一直很好。
あなたの生き様は格好いいです。	你的生活方式很酷。
いつまでに連絡すればいい？	到什么时候为止联系会比较好？
いつ伺えばいいですか？	什么时候去拜访您比较好？
いつお風呂は直りますか。	浴室什么时候能修好？
くそ！格好いいことばかりぬかす！	屁！尽说漂亮话！
いまだかつてないほどすばらしい．	空前大好
いつ彼に会ったら良いのかわかりません。	我不知道什么时候见他才好。
いつ彼に会ったら良いのかわかりません。	不知道该什么时候见他好。
いつも親切にしてくれてありがとう。	谢谢你总是对我这么好。
いや、私たちは彼に手を貸したほうがよい。	不，我们还是帮他一把比较好，
このムートンの上着は暖かくて格好いい。	这件羊皮上衣又保暖又好看。
それはすごく好い所だったみたいだね。	那个曾经似乎是个很好的地方。
いつそちらに行けばいいか教えてください。	请告诉什么时候去你那里好。
いつまたここに戻って来ればよいのか分かりません。	我不知道什么时候再回到这里好。
いつまでにそれを見積もればいいですか。	我在什么时候之前估算那个比较好？
いつまでにそれを支払えばよいのですか？	我在什么时候之前支付那个好？
いつそのチケットを買ったら良いですか？	我什么时候买那个票好？
人物は好いのだが，少し頭が悪いだけだ．	人还不错，就是脑瓜儿不太灵。
いい気になりすぎてはいけない，やはり謙虚な方がよい．	你可别太自恃，还是谦虚一点好。
今まではリムジンで着くのが「格好いい」と言われたのが、だんだんエコカーの方が「格好いい」という時代になるでしょう。	以前坐豪车抵达会被说好帅啊，但渐渐会变成了坐环保车比较帅的时代吧。
それに、彼がトロンボーンを吹いている姿がとても格好いい。	而且，他吹长号的样子特别帅。
いや、僕はやらないよ。彼はフットボールですらそんなに上手くないよ。	不，我不做。他连足球踢得都不是那么好。
いつジェーンに電話すればよいのだろうかと思っています。	我在想什么时候给简打电话好。
いったい、私は何度同じ事を言わなければならないのですか。	我到底要把同一件事情说几遍才好？
いずれにせよ、問題が解決出来て良かったと思います。	不管怎么说，我觉得问题解决了很好。
いざという時になって度を失い，どうしていいかわからない．	到时候慌了神，不知怎么办才好。
いらだって居ても立ってもいられず，どうしたらよいかわからない．	急得站也不是，坐也不是，不知怎样才好。
連日雨模様だったので天気を心配していましたが、幸い好い天気に恵まれました。	一连几天看似要下雨，好在都是好天气。
いざという時に初めからおじけづいていては，どうして事をうまくやることができようか．	临事先畏怯，怎么能做得好。
建設に鋭意努める．	锐意建设
鋭意進歩を求める．	锐意求进
目下、鋭意作業中でございます。	眼下我正在专心工作。
浦東開発の第二期十大プロジェクトが鋭意進行中である．	开发浦东的第二批十大建设项目正在紧张进行。
影印本．	影印本
チャートはＡＡＡの移り変わりを表している。	图表显示了AAA的变迁。
彼らは声をそろえて「えいえいおう」と叫んだ。	他们齐声喊着“嗨哟嗬”。
食糧は農民の営々たる労働のたまものである．	粮食是农民辛勤劳动的成果。
食糧は農民の営々たる労働のたまものである．	粮食是农民辛勤劳动的成果。
食糧は農民の営々たる労働のたまものである．	粮食是农民辛勤劳动的成果。
永遠の主題．	永恒的主题
彼は永遠の野球少年だ。	他是永远的棒球少年。
彼の話は永遠に続きそうだった。	他的话好像永远也说不完。
彼のもくろみは永遠に実現しないだろう．	他的暗算是永远不会得逞的。
先生が私を育ててくださったことは永遠に忘れ難い．	老师对我的培养永远难忘。
これらの直言は私は永遠に心に銘記するだろう．	这些诤言我将永远铭记在心里。
（あの世とこの世は永遠に隔たる→）（死者を悼んで）幽明永遠に境を異にする，いったん死別すればもう二度と会えない．	幽明永隔((成語))
この度の見送りが永遠の別れになるとは，誰が考えたであろうか．	谁想得到，这次送别竟成了永别。
彼らが奴隷として踏みにじられる時代は永遠に終わった．	他们被奴役践踏的时代永远地结束了。
（自問自答して）彼は死んだか？いや，彼は永遠に人々の心の中に生きている．	他死了吗？不，他永远活在人们的心里。
永遠に尽きない，永遠になくならない．	永不枯竭
永遠に共に	永远一起
永遠に一緒	永远在一起
永遠に見守る。	永远守护你。
永遠にさびない．	永不生锈
永遠に記憶にとどめる．	永记心头
永遠に常に新しい．	终古常新
永遠の眠りにつく。	长眠。
永遠の眠りにつく	永远沉睡
永遠に愛している。	永远爱着。
永遠に私の宝物	我永远的宝贝
永遠にさよなら。	永远地再见了。
永遠に光芒を放つ．	永放光芒
永遠に後退しない．	永不后退
永遠に後悔しない．	永不反悔
永遠に消え去らない．	永不磨灭
永遠に変わらない．	终古不变
あなたを永遠に愛し続けます。	我会永远爱你。
この絆を永遠に続けたい。	我想让这份羁绊永远持续下去。
あなたの幸せは永遠に続く。	你的幸福将永远持续。
それが永遠に続くと信じる。	我相信那个会持续到永远。
これは永遠には続かない。	这个不会永远的持续下去的。
あなたを永遠に愛しています。	我会永远爱你。
太郎と永遠に生きる。	和太郎一起永远生活下去。
永遠に見守っているよ。	我会永远守护你。
とどまるところ永遠になし．	永无底止
浩然の気は永遠に不滅である．	浩气长存((成語))
信仰は永遠に変わらない．	信仰永恒
彼は永遠に去ってしまった．	他永远走了。
永遠にあなたと共に暮らしたい。	我想永远和你一起生活。
血縁によって永遠に関係する	因血缘而永远存续的关系
私には永遠に消し去りたい過去がある。	我有一段想永远抹掉的过去。
永遠に幸せが続きますように。	希望幸福永远持续下去。
そこには、優雅な時間が永遠に流れている。	那里永远流淌着平静的时光。
千古にわたって光り輝く，永遠に光彩を放つ．	彪炳千古
永遠に光芒を放つ，永久に光り輝く．	永放光芒
私のあの友人は既に永遠の眠りについた．	我的那位朋友已经永眠了。
彼は永遠に我々の心の中に生きている．	他永远活在我们的心中。
両国の友情が永遠に栄えますように！	祝两国的友谊万古常青！
我々の国は永遠に変質しない．	我们国家永不变色。
（精神・人徳などが）永遠に存在し続ける．	万古长存((成語))
我々の友情は永遠に変わりません。	我们的友情永远不变。
彼らは永遠にお互いを愛し合い続けるでしょう。	他们会互相永远的爱下去吧。
この良い関係を永遠に続けたい。	我想让这个良好关系永远持续下去。
彼が満たされ癒されることは永遠にない。	他永远不会满足。
永遠に子供でありたいと思いました。	我曾想永远当个孩子。
永遠のように感じるかもしれない	可能会感到这好像是永远。
あなたは私の心の中で永遠に生き続けます。	你永远活在我心中。
彼の話は永遠に続きそうだった。	他的话好像永远也说不完。
そのバンドを永遠に愛しています。	我永远热爱那个乐队。
英明にして果断である．	英明果断
この映画の効果はとてもよい．	这部电影的效果很好。
もし英語を上達させたいなら。	如果想让英语进步的话。
結局、英語の方がいい。	结果还是英语比较好。
英語を話せると楽しいよ。	如果会说英语会很开心的。
その結果を次の行動に反映させたい。	我想把那个结果反映到下次的行动上。
衛星センサーの最初の観測結果	卫星传感器最初的观测结果。
それらの結果は治療に反映されない。	那些结果没有从治疗中反映出来。
自分の能力を反映した成果が出せたと感じる。	感到得到了能反映出自己能力的成果。
この種の果物は栄養たっぷりだ．	这种水果富于营养。
照明が悪いと，上演効果に影響する．	灯光不好，就会影响到演出效果。
もし五分早く来てさえいたら、電車に乗れたのに。	如果能早来5分钟的话，就能赶上电车了。
貴方さえいなければといつも思います。	我常常想如果没有你的话。
食糧は農民の営々たる労働のたまものである．	粮食是农民辛勤劳动的成果。
１２週目にＨｂＡ１ｃを下げるという結果が出て、その効果は研究が終わるまでずっとみられた。	第12周出现了糖化血红蛋白下降的结果，这个效果一直持续到研究结束。
そのため、判定結果を示す図7（D）には反映されない。	因此，在指示判断结果的图 7D上没有反映出噪声 22。
その結果、表示パネル1Hに相手の映像が表示される。	结果，对应方的画面显示在显示面板 1H上。
【図12】設定変更結果を反映したプレビュー画像を示す図である。	图 12是表示反映了设定变更结果的预览图像的图。
【図15】設定変更結果を反映したプレビュー画像を示す図である。	图 15是表示反映了设定变更结果的预览图像的图。
【図19】設定変更結果を反映したプレビュー画像を示す図である。	图 19是表示反映了设定变更结果的预览图像的图。
【図36】設定変更結果を反映したプレビュー画像を示す図である。	图 36是表示反映了设定变更结果的预览图像的图。
社長が分かったふりをして経営しているケースが、最も成果が悪い。	社长装明白经营的业务，成果最差。
我々は打合せの結果を反映して、仕様書を修正します。	我们按照讨论的结果，修改了工序说明书。
今回の結果は複合的な影響によるところが大きい。	这次的结果受到复合性的影响很大。
その結果、撮影画像P1〜P4を用いて生成される合成画像にも影響する。	其结果，也影响到使用摄影图像 P1～ P4所生成的合成图像。
私の英語が不自然だったら自然な英語を教えて欲しい。	如果我的英语不自然的话请教我比较自然的英语。
私たちの英語に間違いがあったら正しい英語を教えてください。	如果我们英语是错的话，请告诉我们正确的英语。
過去の販売実績について、お教えいただけると幸いです。	如果您能告诉我过去的销售成绩的话就太好了。
期待さえ抱かねば、心穏やかにもなれるはずだ。	如果连期望都不抱的话，内心应该会变得平静。
別途、英文必要な場合、連絡します。	如果还需要英文，我会再联系。
英語ができればもっと楽しく話せたのにね。	如果会说英语就能更开心的聊天了。
英語を読んで理解することならできます。	如果是阅读并理解英语的话，我可以。
英単語を100個覚えることができたら寝れます。	如果记住了１００个英语单词就能睡觉了。
英文が間違っていたらごめんなさい。	如果我的英语说错了很抱歉。
英語が話せたらもっとよかったのにな。	我如果能说英语，就更好了。
良かったら、僕に英語を教えてくれませんか？	如果可以的话，能教我英语吗？
もしその設定が違うと、検査に影響が出ます。	如果那个设置不对的话，会影响到检查的。
もし私の英語に間違いがあったら、直してください。	如果我的英语有错误的话请你改正。
もし、私が英語を流暢に話せたら素晴らしい。	如果我能流利地说英语的话就好了。
自分の英語力に自信を持てたらなあ。	如果对自己的英语能力有自信的话就好了呢。
もし英語をしゃべれたなら、私はアメリカに行くのに。	如果会说英语了我就去美国了，但是。
私は今英語が自由に喋れたらと思います。	我在想如果我能自由地说英语就好了。
できればあなたは英語でその手紙を書いてください。	如果可以的话，请你用英语写那封信。
私の英語が間違っていたらごめんなさい。	如果我的英语错了那很抱歉。
私の英語に間違いがあったら教えてください。	如果我的英语有错误的话请告诉我。
英単語を100個覚えることができたら寝れます。	如果能背过100个英语单词就能睡得着了。
英文が間違っていたらごめんなさい。	如果英语说错了那很抱歉。
できれば、私はあなたに英語を教えてもらいたいです。	如果可以的话，我想让你教我英语。
それを引き受けてくれたら私は光栄です。	如果你能接受那个将是我的荣幸。
今、英語は世界共通語の役割を果たしている。	现在英语正发挥着世界通用语言的作用。
英会話．	英语会话
英会話を習いたい。	想学习英文对话。
英会話が不得意です。	我不擅长说英语。
英会話のレッスン	英语会话的课
英会話が苦手です。	我不擅长英语对话。
英会話はまったくできない。	我完全不会英语会话。
英会話学校に通う。	上英语会话的学校。
英会話の無料レッスン	英语会话的免费课程
英会話スクールに通う。	上英语会话学校。
本当に英会話が下手です。	我真的不擅长英语对话。
毎週英会話教室に通う。	我每周都去英语会话教室。
今日英会話に行きます。	今天我去英语会话班。
英会話を上手になりたい。	我想变得擅长用英语对话。
英会話の無料レッスン	英语会话的免费课程。
英会話学校に行っている。	我在上英语口语学校。
英会話の先生を探している。	我在找英语口语老师。
英会話はまったくできない。	我完全不会英语对话。
英会話に行っているのですか？	你在进行英语对话吗？
英会話は得意ではありません。	我不擅长进行英语对话。
毎週金曜日に必ず英会話教室に行きます。	我没周周五一定会去英语会话教室。
今日は、英会話の授業がありますか。	今天有英语对话的课吗？
現在英会話のスクールに通い始めたところです。	现在我正开始上英语会话的学校。
英会話を初めて1年になります。	我开始英语会话快一年了。
英会話学校に行ってみようかな。	要不要去英语会话学校看看啊。
英会話学校に通い始めました。	我开始去英语会话学校上课了。
一昨日の英会話スクールは、とてもよかったよ。	前天的英语会话学校特别好。
英会話に挑戦するのは初めてです。	这是我第一次挑战英语对话。
私の目的は英会話を学ぶことでした。	我的目的是学习英语会话。
あなたに会う時まで、英会話の勉強を続けます。	我直到见到你之前都会继续学习英语。
いつ英会話の教師になったのですか。	你是从什么时候变成英语会话的老师的？
英会話学校へ行った方がいいよ。	你去英语会话学校比较好哦。
今日は英会話サークルに行きました。	我去了英语会话的社团。
英会話を習うのは初めてです。	我是第一次学习英语会话。
英会話の勉強を少しだけしました。	我学习了一点英语对话。
私に役に立つ英会話を教えてくれた。	你教给了我很有用的英语对话。
今月の英会話教室の予定は20日です。	这个月的英语对话教室安排在20号。
彼は7月から英会話学校に通っています。	他从7月起一直在上英语会话学校。
もっと英会話を勉強しなければならない。	我必须更努力地学习英语对话。
英会話のリスニングの練習は出来ますか？	可以进行英语听力的练习吗？
彼は私の英会話の練習や勉強を助けてくれる。	他会帮助我练习和学习英语。
彼は小学生の時、英会話を習っていた。	他在小学的时候学习了英语会话。
英会話をもっと上手になりたい。	我想变得更擅长用英语对话。
英会話を教えてくれる先生を探しています。	我在找教我英语会话的老师。
なぜ英会話の先生になったのですか。	你为什么变成了英语会话的老师？
そちらには英会話だけのクラスはありますか？	那边有只有英语会话的班吗？
ジョンさんに英会話を習っていたところです。	我正在向John学习英语会话。
ジョンさんに英会話を習っています。	我在向John学习英语会话。
私は英会話がそんなに得意な方ではありません。	我并不是那么擅长说英语。
私は夜に英会話の授業を受けました。	我晚上上了英语会话课。
私は英会話を初めて1年になります。	我开始英语会话已经1年了。
屈曲部132Aは、上面端部が水平面に対して下方側へ鋭角（傾斜角度θ）に曲げられた部位である。	弯曲部 132A为上表面的端部相对于水平面以锐角 (倾角θ)向下弯曲的部位。
この凹陥部23には角部22xが設けられ、この角部22xは直角、鋭角、或いは鈍角に形成し、この角部22xに倣ってベルト端縁部18Zが折り曲げる。	在该凹陷部 23设有角部 22x，该角部 22x形成为直角、锐角或钝角，使传动带端缘部 18Z按照该角部22x弯折。
例えばベルト素材が弾性に富んで伸び易いときには鋭角に設定することか好ましく、逆にベルト素材が剛性に富んで容易に伸張しないときには鈍角に設定する。	例如，优选在传动带的原料极具弹性而易于拉伸时将角度α设定为锐角，相反，在传动带的原料极具刚性而难以拉伸时将角度α设定为钝角。
このベルト折曲げは、ベルト材質に応じて角度αが鋭角、直角、鈍角などに屈折されるため、ベルト長さ方向に駆動力が作用してもベルトの止め位置がズレることがない。	由于该弯折是根据传动带材质使角度α为锐角、直角、钝角等地折曲，因此即使在传动带长度方向上作用驱动力也不会使传动带的固定位置产生偏离。
この凹陥部23には角部22xが設けられ、この角部22xは直角、鋭角、或いは鈍角に形成し、この角部22xに倣ってベルト端縁部18Zが折り曲げる。	在该凹陷部 23设有角部 22x，该角部 22x形成为直角、锐角或钝角，使传动带端缘部 18Z按照该角部22x弯折。
このベルト折曲げは、ベルト材質に応じて角度αが鋭角、直角、鈍角などに屈折されるため、ベルト長さ方向に駆動力が作用してもベルトの止め位置がズレることがない。	由于该弯折是根据传动带材质使角度α为锐角、直角、钝角等地折曲，因此即使在传动带长度方向上作用驱动力也不会使传动带的固定位置产生偏离。
例えばベルト素材が弾性に富んで伸び易いときには鋭角に設定することか好ましく、逆にベルト素材が剛性に富んで容易に伸張しないときには鈍角に設定する。	例如，优选在传动带的原料极具弹性而易于拉伸时将角度α设定为锐角，相反，在传动带的原料极具刚性而难以拉伸时将角度α设定为钝角。
前述の通り、AF評価値は、撮像素子106からの出力信号を処理して得られる画像の鮮鋭度（コントラスト値ともいう）を表し、鮮鋭度は撮像光学系の合焦状態によって変化するので、撮像光学系の合焦状態を評価する焦点信号となる。	如上所述，AF评价值代表通过处理来自摄像装置 106的输出信号而获得的图像的锐度 (或称为“对比度值”)，并且由于锐度根据摄像光学系统的对焦状态而变化，因而 AF评价值是用于评价摄像光学系统的对焦状态的焦点信号。
ビデオ後処理モジュールは、ビデオデコーダ14の出力を処理することができ、平滑化、鮮鋭化（sharpening）、輝度調整、および／またはコントラスト強調、ならびにFRUCユニット22に関して上述したFRUC動作など、様々な処理動作を実行することができる。	视频后处理模块可处理视频解码器 14的输出，且可执行多种处理操作，例如平滑化、锐化、亮度控制，和 /或对比度增强，以及上文关于 FRUC单元 22描述的 FRUC操作。
彼女はミスユニバースの栄冠を手に入れた．	她摘取了世界小姐的桂冠。
中国女子バレーが前回に引き続いて優勝の栄冠を守ることに成功した．	中国女排卫冕成功。
SF映画	科幻电影
映画．	电影儿
映画界．	影坛
エロ映画，ポルノ映画．	黄色电影
愛情映画，恋愛映画．	言情片
映画を撮る	拍电影
ばかな映画	无聊的电影
白黒映画	黑白電影
映画を作る。	制作电影。
映画の規模	电影的规模
映画をみる。	看电影。
映画を観た。	观赏了电影。
映画を見た。	我看了电影。
長編映画．	大型影片
テレビ映画．	电视电影
映画を見る．	看电影
カラー映画．	彩色电影
映画スター．	电影明星
映画の切符．	电影票
映画俳優．	电影演员
映画週間．	电影周
時代劇映画．	古装片
劇映画．	故事片
国産映画．	国产影片
スリラー映画．	惊险片
カラー映画．	彩色片子
映画が替わる．	换片子
野外映画．	露天电影
ビデオ映画．	录像片
ポルノ映画．	裸体电影
映画スター．	电影明星
西部劇映画．	牛仔片
封切り映画．	头轮影片
西部劇映画．	西部片
喜劇映画．	喜剧片
扇情映画．	香艳电影
宣伝映画．	宣传片子
映画俳優．	电影演员
劇映画．	故事影片
娯楽性の強い映画・テレビ映画．	娱乐片
映画を見に行く。	去看电影。
夜の映画館	晚上的电影院
実写版の映画	纪实电影
映画を予約する。	预约电影。
おすすめの映画	推荐的电影
映画の撮影	电影的拍摄
映画を観に行く。	去看电影。
映画を見ました。	观看了电影。
映画シナリオ．	电影剧本
アダルト映画．	成人电影
山西省に源を発し衛河に注ぐ川の名．	漳河
映画界．	影坛
映画界の女王．	电影皇后
映画界に入る．	进入影界
彼は映画界の新星になった．	他成为影坛新星。
彼は映画界で多年にわたって監督してきた．	他在电影界执导多年。
夜の映画館	晚上的电影院
映画館．≒影院．	电影院
映画館に行きたい。	我想去电影院。
その映画館は混む。	那家电影院人很多。
映画館もう満席だ。	电影院已经满座了。
キャセイ映画館．	国泰电影院
最近は映画館へ行っていない。	最近没去电影院。
私は映画館にいたい。	我想呆在电影院。
この映画館は安くないです。	这家电影院不便宜。
今日は映画館に行きました。	我今天去了电影院。
その映画館はとても空いていた。	那个电影院很空。
映画館に行くのが嫌です。	我讨厌去电影院。
映画館で7年間働きました。	我在电影院工作了7年。
映画館とボーリング場です。	是电影院和保龄球场。
映画館を新しく建てた．	新修了电影院。
映画館内は禁煙です．	电影院内不许抽烟。
いずれの映画館でもご鑑賞いただけます。	任何一家电影院都能观看。
貴方は明日映画館にいくのですか？	你明天去电影院吗？
その映画館は人気があるので混む。	那家电影院因为很受欢迎而人很多。
映画館では映画をやっていますか？	在电影院有电影正在上映吗？
この映画館は割引がありません。	这家电影院没有打折。
映画館の無い小さな町に住んでいます。	我住在没有电影院的小镇。
この施設には映画館やホール、レストランがあります。	这个设施里有电影院，礼堂，饭店。
息子と彼の友達を映画館に連れて行きました。	我带着儿子和他的朋友去了电影院。
クラスメイトに、映画館に行かないかと誘われました。	同学邀请我去电影院。
映画館は声がはっきり聞こえる。	在电影院声音听得很清楚。
いつものように映画館に出かけた。	像往常那样去了电影院。
初めて映画館で観た映画は？	第一次在电影院看的电影是什么？
マッサージや映画館に行きました。	我去了按摩店和电影院。
これは新しく建てた映画館である．	这是新修的电影院。
人々が映画館からどっとあふれ出て来た．	人们从电影院涌了出来。
（劇場・映画館・寄席などの）娯楽施設．	娱乐场所
（鉄道の）出札係，（劇場・映画館の）切符売り，（バスの）車掌．	售票员
映画館の後ろの方にはまだ多くの空席がある．	电影院的后排还有不少座儿。
その映画館ではおもしろい映画がたくさん上映されている。	那家电影院在放很有意思的电影。
その映画館の入り口やロビーにあるモニターをご覧になりましたか？	你看到那家电影院入口和大厅的监视器了吗？
普段、どのくらいの頻度で映画館に映画を観に行かれますか。	你平常以怎样的频率去电影院看电影啊？
子供のころから映画が好きで、よく映画館に行っていた。	从小的时候就喜欢电影，经常去电影院。
（映画館・劇場の総称として）映画・演劇を放映・上演する施設．	影剧院
今度の日曜日の昼12時に映画館の前で待ち合わせをして食事をしてから映画を観ましょう。	下周日中午12点在电影院前面集合然后吃饭，之后再看电影吧。
僕は将来映画監督になることが夢です。	我的梦想是将来成为电影导演。
彼は映画監督であり、フォトグラファーでもある。	他既是电影导演，又是摄影师。
彼は映画監督として有名である。	他作为电影导演很有名。
欧米の映画監督が監督したが，俳優はすべて中国人である．	虽然是西方导演执导，演员都属于中国人。
その映画監督はポルノ製作者として監督人生を始めた。	那位电影导演是以色情片制作人的身份开始了的导演生涯。
小学校（中学・高校）三級教員．（専門技術職の初級職に属し，この他，脚本家・作曲家・映画監督・俳優・操縦士・機関士などにも‘级’が設けられている．）	小学（中学）三级教师
映画撮影所．	电影制片厂
映画撮影機．	［电影］摄影机
この閲覧室で映画撮影が行われました。	这个阅览室里进行了电影的拍摄。
映画撮影はクランクアップするまで誰も気が抜けない。	电影拍摄杀青之前谁也不敢松懈。
例えば、ColorFunctionは、標準バージョン（V1）からの各色値を拡張バージョン（V2）の色値にマッピングする方法を定義するルックアップ・テーブルの仕様であってもよいし、メタデータにおいて定義、特定されているか、例えば、更に後述する米国映画撮影監督協会の色決定リスト（ASC CDL：American Society of Cinematographers Color Decision List）を用いて予め定義されているような多項式またはその他の関数のパラメータであってもよい。	例如，颜色函数或者可以是定义了如何将标准版本 (V1)的每个颜色值映射成增强版本 (V2)的颜色值的查找表的规定，或者可以是元数据中所定义和指定的多项式或其他函数的参数或利用例如以下将进一步讨论的美国电影摄影师颜色决定列表协会(ASC CDL)所预先定义的多项式或其他函数的参数。
映画撮影機．	［电影］摄影机
その映画人のコレクションを見せてもらった。	给我看过那位电影人的收藏。
映画関係の仕事に携わる人，映画人．	电影工作者
映画スター．	电影明星
映画スター．	电影明星
映画のポスター．	电影海报
映画・テレビのスター．	影视明星
（映画名）スターウォーズ．≒星际大战．	星球大战
花形映画女優，スター女優．	女影星
この映画が彼女を大スターにした。	这部电影让她成为了大明星。
ジェーンは上海の映画スターと知り合いだ。	简和上海的电影明星相识。
壁には映画スターの写真が一列に張ってある．	墙壁上贴着一列电影明星的照片。
日本の著名な映画スター高倉健．	日本著名影星高仓健
その映画スターの到着に際して熱狂の嵐が巻き起こった。	在那个电影明星到来之际掀起了暴风雨般的狂热浪潮。
彼女は往年の映画スターのように華麗に着飾っていた。	她像以往的电影明星一样盛装打扮了。
たとえば、バットマンの映画を参照すると、曲「Who’s Next」およびバットマンのポスターは全てメディアプレゼンテーションである。	例如，对电影蝙蝠侠、歌曲“Who′ s Next”和蝙蝠侠海报的引用全部是媒体呈现。
それから、彼は映画スターとして大活躍し、多くの有名作品の出演者となっていった。	从那之后，他作为电影明星大显身手，成为了多部著名作品的演出者。
それから、彼は映画スターとして大活躍し、多くの有名作品の出演者となっていった。	从那个时候起，他作为电影明星非常的活跃，出演了很多有名的作品。
特定の例として、バットマンの映画は、商業用仮想アセットに関連することができ、バットマンのポスターは、販促用仮想アセットに関連することができる。	作为一特定示例，蝙蝠侠电影可与商业虚拟资产相关联，并且蝙蝠侠海报可与促销虚拟资产相关联。
私の趣味は映画鑑賞です。	我的兴趣是鉴赏电影。
いずれの映画館でもご鑑賞いただけます。	任何一家电影院都能观看。
私の趣味は映画鑑賞と読書です。	我的兴趣爱好是看电影和读书。
私の趣味は、旅行、読書、映画やビデオ鑑賞です。	我的兴趣是旅行读书电影和看录像。
私の趣味は、サイクリングと映画鑑賞です。	我的兴趣是骑自行车和电影鉴赏。
私の趣味はバスケットボールをすることと映画鑑賞です。	我的兴趣是打篮球和电影鉴赏。
私の趣味はバスケットボールをすることと映画鑑賞です。	我的兴趣是打篮球和看电影。
私の趣味は、旅行に読書、映画やビデオ鑑賞です。	我的爱好是，旅游，读书，看电影和视频。
映画俳優．	电影演员
映画俳優．	电影演员
長年引退していた老映画俳優がもう一度出演して容姿を人前に現わす．	这位息影多年的老演员将登台再展风采。
敵の鋭気をそぐ．	挫敌锐气
青年には貴ぶべき鋭気がある．	青年有可贵的锐气。
鋭気はそがれほとんど尽きた．	锐气消损殆尽。
敵の鋭気をしぼませ，味方の士気を膨らませる．	挫敌人的锐气，长自己的威风。((ことわざ))
戦闘を始めるとかつての鋭気は少しも衰えていない．	打起仗来不减当年的锐气。
（顔などが）角張っている，顔つきが厳しい，人柄が方正で筋道を曲げない，言葉が鋭くて容赦がない，非常に厳しい，鋭気・才気があふれている．	有棱有角
おっ！	哦！
王明！—おおっ！	王明！—有！
お宅．	贵府
お宅．	尊府
おお。簡単だ。	哦。很简单。
お金をおろす。	取钱。
おやおや。	哎呀哎呀。
笑おう。	笑吧。
お叱り	叱责
お願い！	拜托了！
おわった？	完了？
お疲れ。	辛苦了。
会おう。	见面吧。
おねがい～。	拜托。
おススメ	推荐
お試し	试试
大乗．	大乘
お手紙．	大札
おから．	豆腐渣
お手紙．	华翰
おいしい．	受吃
お洒落なお店	时尚的店
お祭りへおいで。	来集会吧。
おそれ多くも．	诚惶诚恐((成語))
おおよその方向．	大致方向
大きな川，大河．	大河
塩．	盐斤
おやじとおふくろ．	老子娘
あれ，おおごとだ．	哎呀，了不得了。
お宅のお嬢様．	千金小姐
お偉方，お歴々．	显要人物
お腹が重い。	我肚子沉。
お風呂を直す。	修浴室。
扇であおぐ．	用扇子扇
王おじさん．	王叔
お届けの際にお持ちしております。	送到的时候我拿着。
お手間をおかけしております。	给您添麻烦了。
またのお越しをお待ちしております。	等待您的再次光临。
おー、お誕生日おめでとう！	哟，生日快乐！
お返事お待ちしております。	等待着您的回复。
またのお越しをお待ちしております。	等候您的再次光临。
お返事をお待ちしております。	我在等待您的回复。
お一人様お一つでお願いします。	一人一个。
お返事をお待ちしております。	等待着您的答复。
お返事をお待ちしております。	我等待您的回复。
お返事をお待ちしております。	等待着您的回复。
お返事お待ちしております。	等候您的回复。
お返事お待ちしております。	等待着您的回信。
（多く子供が言う）お百姓のおじさん．	农民伯伯
お返事をお待ちしております．	请早日回复为盼。
あなたは砂漠のオアシスです。	你是沙漠的绿洲。
砂漠がこのオアシスをぐるっと取り巻いている．	沙漠环抱着这片绿洲。
【図6】オーディオアンプの構成例を示すブロック図である。	图 6是示出音频放大器的配置例子的框图。
バイオアベイラビリティーは薬の開発で用いられる用語である。	生物利用度是在藥物開發中使用的術語
私はファイト・オア・フライト反応に関心を持っている。	我对战斗或逃跑的反应感兴趣。
丸めは、ビデオアーキテクチャによって制限されていない場合、必要でないことがある。	 如果不受任何视频架构限制，则舍入可不为必要的。
スイッチ（ラッチ出力制御部）SW2の他端はオア回路OR1の入力に接続される。	开关 (闩锁输出控制部 )SW2的另一端连接到逻辑或电路 OR1的输入端上。
オアシス周辺では荷物を運んでいるたくさんのヒトコブラクダが見られる。	你可以看到在绿洲附近有很多运货物的单峰骆驼。
広大なゴビ砂漠で，私たちは思いがけなくこのオアシスを発見した．	在千里戈壁滩上，我们意外地发现了这块绿洲。
抽出モジュール110は、ステップ210で受信した注釈のイベントを、ビデオアクセスログ129から抽出する。	提取模块 110从视频访问日志 129提取接收的注释事件 210。
【図13】ビデオアクセスユニット内の補足データ領域に格納されるデコードスイッチ情報のデータ構造を示す図である。	图 13是示出在视频存取单元内的补充数据区域中所保存的解码切换信息的数据结构的图。
しかし、複数のスピーカ装置間でそのようなタイミング同期精度を必要としてもよい他のオーディオアプリケーションが存在する。	然而，可能存在要求多个扬声器设备间如此定时同步精度的其他音频应用。
チャネル514は、任意である第2の出力634によって描写される。 この場合におけるこの出力は、コンピュータへの直接録音を可能にするUSBオーディオアナログ・デジタル変換デバイスである。	用可选第二输出 634描绘声道 514，在这种情况下可选第二输出 634是USB音频模拟 -数字设备，以允许直接到计算机录音。
同期駆動素子50が、例えば、カスタムの固体光源駆動電子装置と連結したWestar VP−7ビデオアダプタ（Westar Display Technologies，Inc．，St．Charles，Missouri）などの、ビデオインターフェースを含むことができる。	同步驱动元件 50可包括连接到定制的固态光源驱动电子器件的视频接口，例如Westar VP-7视频适配器(Westar Display Technologies，Inc.，St.Charles，Missouri)。
図示した例では、HDMIコネクタ1（4011）には例えばDVDプレイヤのような再生装置−1が、HDMIコネクタ2（4012）にはオーディオアンプやスピーカを備えるオーディオシステムが、直接接続されていることを示す。	在图示的示例中，表示例如 DVD播放器等再现装置 -1与 HDMI连接器 1(4011)直接连接，具备音频放大器或扬声器的音频系统与 HDMI连接器 2(4012)直接连接的情况。
例えば図6および7に示した処理をプレーヤー402内で行い、オーディオアンプ403ではその映像信号をそのまま出力して音信号の再生のみを行ってもよい。	例如也可以在播放器 402内进行图 6和图 7所示的处理，在音频放大器 403中将该影像信号直接输出，只进行声音信号的再现。
オア回路（論理回路）OR1の入力はさらにコンパレータ8の出力およびラッチ回路14の入力に接続され、出力はエッジ検出器10の入力に接続される。	逻辑或电路 (逻辑电路 )OR1的输入进一步连接到比较器 8的输出端和闩锁电路14的输入端，输出端连接到边缘检测器 10的输入端。
ソースデバイス12のビデオソース20は、ビデオカメラ、あらかじめキャプチャされたビデオを含んでいるビデオアーカイブ、またはビデオコンテンツプロバイダからのビデオフィードなど、ビデオキャプチャデバイスを含むことができる。	源装置 12的视频源 20可包括例如摄像机的视频捕捉装置 (video capture device)、含有先前捕捉的视频的视频档案 (video archive)，或来自视频内容提供者的视频馈送 (video feed)。
アクセスログ129内の各エントリー（入力）は、アクセスされているビデオ、アクセス時間、ユーザのIPアドレス、もし利用可能であればユーザID、クッキー、検索クエリー、ビデオとのインタラクション（相互作用）のタイプを識別するデータ、ビデオとの各インタラクション毎の時間など、を同定（識別）する。	访问日志 129中的每个条目标识被访问的视频、访问时间、用户的 IP地址、用户 ID(如果可获得 )、cookie、搜索查询、标识与视频的交互类型的数据以及与视频的每个交互的时间。
テスト410において、アプリケーションに有用な情報を含まないとRDSパケットが決定された場合、局識別情報が、局識別RDSパケットから抽出され、ディスプレイ20上での表示のために、ハンドヘルドデバイス中で実行しているFMラジオアプリケーションに提供される、ステップ482。	 如果在测试 410中确定 RDS包不含有应用程序有用信息，那么可从电台识别 RDS包提取电台识别信息，且提供到在手持装置上运行的 FM无线电应用程序 (步骤 482)，以用于在显示器 20上呈现。
基地局60に関連するBSN53及びPDSN52は局所的な通信システム（例えば、アクセスネットワークまたはラジオアクセスネットワーク）を構成することができ、地理的領域または仮想領域に関する無線通信装置70、72、74、76への通信を集合的に制御するだろう、他のサーバサイド50コンポーネントをさらに含むかもしれない。	PDSN 52和 BSN 53以及相关联的基站 60可构成区域性通信系统 (例如，接入网或无线电接入网 )，并且还可包括其他服务器侧 50组件，它们将共同控制去往一地理或虚拟区域的无线通信设备 70、72、74、76的通信。
図9Cのシステムディストリビュータ60Mのブロック図は、両方向データプロセッサ80を介したビデオインターホンモニタ82との間の両方通信を示し、両方向データプロセッサ80は、オーディオ、ビデオ、アラーム、ホームオートメーションおよびデータを両方向に処理して、特に、USBドライバ64を介しインターネット67を経由してPC66との間で、例えばオフィスにいるまたは他の場所の住宅所有者と通信することを可能にする。	图 9C的系统配电器 60M框图示出了视频对讲机监视器 82经由双向数据处理器 80之间的双向通信，双向数据处理器 80双向处理音频、视频、警报、家庭自动化和数据用于尤其实现 PC 66经由 USB驱动器 64之间的通信以及通过互联网 67与家庭主人例如在他的办公室或从其他地方通信。
プリフェッチモジュール22は、優先度が比較的高いデータパケット（例えば、ボイス・オーバー・インターネット・プロトコル（VOIP）アプリケーションのようなリアルタイムオーディオおよび／またはビデオアプリケーションに対応付けられているデータパケット）の場合、例えば、ヘッダ部分およびペイロード部分の両方をプリフェッチする（処理コア14がキャッシュ30でデータパケットのヘッダ部分にアクセスした後でペイロード部分にアクセスする必要がある場合があるためである）。	对于相对高优先级的数据分组 (例如，与实时音频和 /或视频应用 (比如因特网协议语音 (VOIP应用 ))相关联的数据分组 )而言，例如，预提取模块 22预提取报头段和净荷段两者 (因为，处理核 14可能需要在从高速缓存 30访问数据分组的报头段之后来访问净荷段 )。
再生装置の製造主体(マニフャクチャ)が再生装置の出荷時に定めた再生装置の各種コンフィグレーションや、ユーザがセットアップ手順に従い設定した各種コンフィグレーション、そして、再生装置がTVシステムやステレオ、アンプ等のホームシアターシステムの機器と接続された際、接続相手となる機器とのネゴシエーションにより判明した相手側機器のケーパビリティがプレーヤ設定レジスタに設定される。	再生装置的制造主体 (制造商 )在再生装置的出厂时设定的再生装置的各种配置、用户按照设置顺序设定的各种配置、以及再生装置与 TV系统或音响、功率放大器等家庭影院系统的设备连接时通过与作为连接对方的设备的协商判明的对方侧设备的能力设定在播放器设定寄存器中。
2．第2の実施の形態（測位部の動作制御：間欠動作の間欠中に測位部をスタンバイ状態とする例）	2.第二实施例 (定位单元的操作的控制：其中在间歇的操作之间的间隔期间定位单元处于待机状态的示例 )
お愛想言葉，（常套の）あいさつ言葉．	应酬话
お客の前で彼女は愛想よく振る舞った。	她在客人面前表現友好的一面
あの人はおとなしいが，全く愛想がない．	那个人很老实，就是太板。
君，出て行って彼らにちょっとお愛想を言いなさい．	你出去跟他们应酬几句。
彼女はいつもクラスメートたちに愛想のいい笑顔を振りまいている。	她总是对同学们和和气气地笑脸相迎。
台湾省の高雄県では珍しいチョウが豊富にとれる．	台湾省高雄县盛产珍贵的蝴蝶。
足音．	脚步声
明日会おう。	明天见吧。
足を下ろす。	把脚放下来。
明日お目にかかります，ではまた明日．	明天见。
やあしばらく，お元気ですか？	久违了，你身体可好？
足音が響く．	足音跫然
足取りが重い．	脚步很重。
明日お店に行きます。	明天去店里。
お疲れ様、また明日。	辛苦了，明天见。
明日からお休みです。	我从明天开始休息。
明日、大阪へ帰ります。	我明天回大阪。
明日、お暇ですか？	你明天有时间吗？
私は明日お休みです。	我明天休息。
明日大阪に行きます。	我明天去大阪。
明日はお休みします。	明天休息。
明日からお休みです。	从明天开始我休息。
彼は明日大阪に来る．	他明天来大阪。
足元がおぼつかない．	腿脚不灵便
明日きっとおいでよ！	你明天一定来啊！
足の土を足踏みして落とす．	把脚上的土跺下去。
（ふた足をひと足にして→）大急ぎで歩く，大股で歩く．	两步并做一步走
明日君に教えるよ。	明天告诉你啊。
明日、講義を行う。	我明天要去上课。
転んで片足を折った。	我摔断了一条腿。
明日は何時に起きますか？	明天几点起？
明日は6時に起きます。	明天6点起床。
アシの生い茂った水辺．	芦花荡
（足踏み式の）オルガン．	簧风琴
慌ただしい足音．	急骤的脚步声
足取りを遅くする．	放慢脚步
怪しげな足音．	可疑的脚步声
足音が接近した．	脚步声迫近了。
横道に足を踏み入れる．	走入歧路
いすの脚が1本折れた．	椅子折了一条腿。
明日お会いできますことを、楽しみにお待ちしております。	期待地等着明天能见面。
明日は、よろしくお願いします。	明天请多关照。
明日までに考えておきます。	明天前考虑好。
明日家に遊びにおいで。	明天来家里玩吧。
明日貴社へお伺い致します。	我会拜访贵公司。
明日は大雨が降ります。	明天会下大雨。
私たちは明日必ず会おう。	我们明天一定要见面。
明日からお盆休みです。	我从明天开始放盂兰盆假。
でも私は明日お休みします。	可是我明天休息。
明日は会社がお休みです。	明天公司休息。
私は明日から大阪に行きます。	我明天去大阪。
明日から大阪に行きます。	我明天去大阪。
明日から大分へ行くのですか？	你明天开始去大分吗？
明日大阪へ行く予定です。	我明天计划去大阪。
お母さんには明日会えます。	明天能见到母亲。
明日のレッスンはお休みします。	明天的课请假。
御足労をおかけして申し訳ありません。	劳驾您很抱歉。
事務所への御足労大変恐れ入ります。	劳驾您来事务所，真对不起。
御足労を頂き心より厚く御礼を申し上げます。	劳驾您来真的发自内心地表示感谢。
あなたは砂漠のオアシスです。	你是沙漠的绿洲。
砂漠がこのオアシスをぐるっと取り巻いている．	沙漠环抱着这片绿洲。
オアシス周辺では荷物を運んでいるたくさんのヒトコブラクダが見られる。	你可以看到在绿洲附近有很多运货物的单峰骆驼。
広大なゴビ砂漠で，私たちは思いがけなくこのオアシスを発見した．	在千里戈壁滩上，我们意外地发现了这块绿洲。
自給してなお余りがある．	自给有余
自給してなお余りがある．	自给有余
彼はもう1000余りの漢字を覚えた．	他已经认识多汉字了。
この本のページ数は多くない，たった90ページ余りです．	这本书篇幅不多，只有九十页。
お言葉身に余ります，誠に痛み入ります！	您言重了，我实在不敢当！
この半年余り，彼は奥さんとあまり話をしない．	这半年多，他跟太太不常说话。
家に帰る道のりはたいへん遠く，100キロ余りある．	回家的路太远，有一百多公里。
彼が行ってしまってからもう2か月余りになる．	他走了已经有两个多月了。
彼は使命を帯びて英国に赴き既に3年余りになった．	他出使英国已经三年多了。
中国には漢民族以外になお50余りの少数民族がいる．	中国除汉族，还有五十多个少数民族。
張工場長は就任するや否や，1000万元余りの債務を背負った。	张厂长刚一上任，就背上了一千多万元的债务。
猥褻物の制作・販売を行なう300余りの犯罪拠点を取り締まる．	取缔制黄，“贩黄”的犯罪窝点三百多个。
紅軍は2万5千里余りを長駆し，11の省を縦横無尽に駆け巡った．	红军长驱二万五千余里，纵横十一个省。
発注してから商品が届くのが余りに遅いので、注文をキャンセルしたいと思います。	因为订购的商品送货实在是太慢了，所以想取消订单。
［もともと］彼は1か月余りも病気していたんだ，道理で長らく彼の顔を見なかったはずだ．	［原来］他病了一个多月，无怪我们好久没见到他。
写真を撮ったり談笑したりしながら、１時間余りかけて思い思いのペースで走っていました。	一边拍着照片或谈笑，花了1个多小时以各自的节奏奔跑着。
もし、営業が余りうまく行っていないのであれば、例えば、強く売り込む前に、相手のニーズを引き出すようにしてはいかがでしょうか？	营业进行得不是很顺利的时候，比如说，在强烈推销之前先找出对方的需求怎么样？
郷鎮企業が都市に向けて労働者を募集したところ，市内で現在既に1000人余りが応募している．	乡镇企业向城市招工，市内目前已有一千多人应招。
また、f112において、制御部1は、クロック生成器5の位相にnを32で割った余りを設定した後、出力に反映されるまでの時間として同期検出器4より出力される垂直同期割り込みを最低2回待ってから水平開始終了位置検出器7の水平開始位置を取得する。	并且，在步骤 f112中，控制器 1将 n除以 32的余数设为时钟产生器 5的相位，然后，在等待与从同步信号检测器 4输出的至少两个垂直同步中断信号对应的时间 (作为直到阈值电平设定被反映到水平开始 /结束位置检测器 7的输出为止的时间 )之后，从水平开始 /结束位置检测器 7获取水平开始位置。
また、f112において、制御部1は、クロック生成器5の位相にnを32で割った余りを設定した後、出力に反映されるまでの時間として同期検出器4より出力される垂直同期割り込みを最低2回待ってから水平開始終了位置検出器7の水平開始位置を取得する。	并且，在步骤 f112中，控制器 1将 n除以 32的余数设为时钟产生器 5的相位，然后，在等待与从同步信号检测器 4输出的至少两个垂直同步中断信号对应的时间 (作为直到阈值电平设定被反映到水平开始 /结束位置检测器 7的输出为止的时间 )之后，从水平开始 /结束位置检测器 7获取水平开始位置。
お兄ちゃん，お帰り．	哥，你回来了。
二番めの兄，次兄，お兄ちゃん．	二哥
お兄ちゃんはとあるエモ系バンドが気に入っている。	哥哥很中意某个情绪摇滚乐队。
いつもがんばるお兄ちゃんは私の憧れです。	我很憧憬一直在努力的哥哥。
太郎お兄ちゃんこれからも宜しくね！	太郎哥哥，今后也请多指教哦！
父ちゃんが死んでからは，お兄ちゃんが私の父ちゃんだった．	爸死后，哥就是我爸爸。
おいしい．	受吃
雄犬．	雄狗
おいしかった？	好吃吗？
おいしそう。	看起来很好吃。
おいしいです。	很好吃。
おいしい？	好吃吗？
においはない。	没有味道。
おいしいです。	好吃。
味，におい．	味儿
変なにおい．	怪味儿
においがよい．	好闻
においが悪い．	难闻
皆おいでよ！	大家快来呀！
追い付く	追赶
食事がおいしい。	饭很好吃。
線香のにおい	香的味道
花のにおいを嗅ぐ。	闻花香。
おいしいでしょ？	很好吃吧？
遊びにおいでよ。	来玩啊。
家においてきた。	回家了。
におい中和剤	味道中和剂
お祭りへおいで。	来集会吧。
「おいしい！」「何が？」	“好吃！”“什么东西？”
おいくつですか。	几岁了？
おいくらですか。	多少钱？
こっちにおいで。	来这边。
おいしそうだ。	看起来好像很好吃。
おいしいですね。	很好吃啊。
おいしかったです。	很好吃。
なかなかおいしい。	非常好吃。
おいくつですか。	您多大年纪？
おいしいですね。	很好吃呢。
おいしい食べ物	好吃的食物
とってもおいしい。	特别好吃。
ビールがおいしい。	啤酒好喝。
オイオイと泣く．	放声大哭
おい，早く行こう！	嘿，快走吧！
こっちへおいで！	你过来！
火薬のにおい．	火药气味
清新なにおい．	清新的气息
においが抜ける．	走味儿
香水のにおい．	香水味儿
小便臭いにおいがつんと鼻をつく．	臊气刺鼻
原稿を一緒に置いておいた．	把文稿放在一块儿。
原稿を一緒に置いておいた．	把文稿放在一起。
おいしさのポイント	美味度的关键
食べ物もおいしいです。	食物也很美味。
うん、とてもおいしかった。	恩，非常的好吃。
それはおいしそうです。	那看起来很好吃。
それは、おいしかったです。	那个好吃。
オイオイと泣く．	放声大哭
カッターオイル．	切削油
オイルジャッキ．	油压千斤顶
カキ油，オイスターソース．	蚝油
彼女は思わずオイオイと泣きだした．	她禁不住呜呜地哭起来。
別名オイルと言われる。	别名被叫做食用油。
今のオイはおまはんと同類ね。	现在的我跟大婶一样啊。
オイルゲージは満タンを指していた。	油表指向滿油。
そのオイルが洗い流される。	那个油能洗掉。
オイルタンク車，タンクローリー．	油罐车
まつげエクステンションはオイルに弱いと聞いている。	听说嫁接睫毛不太能碰油。
オイルを購入しましたが送料はいくらですか？	购买了油，运费是多少？
その物体はオイルクロスに包まれていた。	那个物体被油布包裹着。
彼は黄色のオイルスキンの防水服を着ていた。	他穿着黄色防水布制的防水服。
そのオピオイドは私の痛みを和らげた。	那个鸦片类药物缓解了我的疼痛。
そこはオイラの部屋だから勝手に入るなよ。	那是我的房间所以不要随便进入。
プラスチック製水タンク・オイルタンク．	塑料桶
図7は、ビデオインタフェース部24の内部構成例を示す。	参考图 7，示出了视频接口块 24的示例性内部配置。
エッセンシャルオイルや天然素材だけを使用しているのが特徴です。	埃森石油的特点是只使用了天然素材。
オイルフィラーキャップのまわりの汚れをふき取りなさい。	请把加油口的盖子周围的污垢擦干净。
この市場で売られているオリーブオイルのほとんどが粗悪品です。	这个市场里买的橄榄油大部分是伪劣商品
彼らはオイルスキンの防水服とゴム長靴で重装備していた。	他们穿上防水衣和橡胶长靴的重装备。
メインディッシュはオイルがいかにも美味しそうだった。	主菜因为油而变得看起来更加的美味。
犬・猫はもちろん、小動物・小鳥などが原因のニオイにも効果的。	猫和狗就不用说了，对小动物和小鸟等产生的气味也有效。
産地直送オリーブオイルセットをご注文頂きありがとうございます。	感谢您订购产地直销的橄榄油套装。
ユーザ・インターフェース510は、ビデオ、イメージ及びテキストをユーザに表示するためのディスプレイ512を含むことが可能である。	 用户接口 510可包括用于向用户显示视频、图像和文本的显示器 512。
Bluetooth無線装置500は、Bluetoothトランシーバ502、タイミングドリフト補償器504及びオーディオイベント検出器506を含んでもよい。	蓝牙无线电500可以包括蓝牙收发器502、定时漂移补偿器504以及音频事件检测器 506。
【図7】本発明の一実施の形態におけるビデオインタフェース部の内部構成例を示すブロック図である。	图 7是图示出图 5所示的视频接口块的示例性内部配置的框图；
エンジンオイルはエンジン内部を潤滑したり、不純物を取り込んで内部を保護する役目があります。	发动机油有润滑引擎内部，带走不纯物保护内部的作用。
制御装置モジュール107はまたオーディオ-ビデオインターフェース1007および通信用のインターフェース1008を含むいくつかの入出力（I／O）インターフェースを備えており、オーディオ-ビデオインターフェース1007が生物測定センサ121に対するI／Oインターフェース1013をLED表示器122およびオーディオスピーカ124に結合する。	控制器模块 107还包括多个输入 /输出 (I/O)接口，包括耦合到 LED显示器 122和音频扬声器 124的音频 -视频接口 1007、用于生物测量传感器 121的 I/O接口 1013、以及用于通信的接口 1008。
値a mod e が1に等しくない場合（ステップ37：NO）、候補数a はRSA アルゴリズムに適合する、すなわち、公開指数e がオイラー関数(p-1)(q-1)と素である整数であるという条件に合っている。	 如果不等于 (块 37输出 N)，备选数字与 RSA算法相匹配，即，其符合指数 e为与欧拉指示符 (p-1)(q-1)互质的整数的条件。
同期駆動素子50が、例えば、カスタムの固体光源駆動電子装置と連結したWestar VP−7ビデオアダプタ（Westar Display Technologies，Inc．，St．Charles，Missouri）などの、ビデオインターフェースを含むことができる。	同步驱动元件 50可包括连接到定制的固态光源驱动电子器件的视频接口，例如Westar VP-7视频适配器(Westar Display Technologies，Inc.，St.Charles，Missouri)。
マルチメディア応答はさらに、オイル交換またはサービス部によって提供される他のサービスのクーポンまたは広告を表示することができる。	多媒体响应还可以显示由服务部门提供的更换机油或者其他服务的优惠券或者广告。
このため垂直方向が反転する場合は、カメラアダプタ装置12内のビデオインタフェース部24は、カメラヘッド10aから受け取ったビデオ信号の出力を1フィールドに相当する時間だけ遅延して出力する。	因此，如果垂直方向被反转，则摄像机适配器盒 12中的视频接口块 24将从摄像机头 10a接收的视频信号的输出延迟与一个场 (field)相当的时间，并且输出经延迟的信号。
このため垂直方向が反転する場合は、カメラアダプタ装置12内のビデオインタフェース部24は、カメラヘッド10aから受け取ったビデオ信号の出力を1フィールドに相当する時間だけ遅延して出力する。	因此，如果垂直方向被反转，则摄像机适配器盒 12中的视频接口块 24将从摄像机头 10a接收的视频信号的输出延迟与一场相当的时间，并且输出经延迟的信号。
例えば、オーディオイベント検出器506は、バッファ512においてバッファリングされたオーディオデータの復号化を開始してもよく、かつ／あるいは相関器最大値が発生した後に規定の時間遅延において（例えば、調整後のオーディオクロック信号540の規定の周期数）PCMデータバッファ516から復号化データの出力を開始してもよい。	音频事件检测器 506例如可以在相关器最大值发生后定义的时延 (例如定义的经调整音频时钟信号 540周期数 )开始对缓存于缓冲器 512中音频数据的解码和 /或开始对来自 PCM数据缓冲器 516的已解码数据的输出。
係属中の米国特許出願明細書に開示されたホームオートメーションの電気システムを制御しているビデオインターホンまたはショッピング端末に信頼性の高いオンオフ状態を与えるためには、図1〜3に示された本発明の調光器回路6MIR、6M−2および6Mを介して図6A〜6Fに示された電流センサを使用することが必要である。	为了向视频对讲机或购物终端（其控制在未决的美国申请中披露的家庭自动化的电气系统）提供可靠的开启 -关断状态，需要使用图 6A-6F中所示的电流传感器并通过图 1-3中所示的本发明的调光器电路 6MIR、6M-2和 6M。
さらに、CPU30は、負荷が、スイッチオンにされたトライアック、スイッチでオフにされたトライアック、または「調光」状態のトライアックに接続されているかどうかを確認することができ、それによって、CPUは、電気器具のオンまたはオフまたは調光状態を積極的に識別し、そのようなデータを、IRドライバ33およびIR送信機13を介して、システム制御装置、ショッピング端末、または係属中の米国特許出願明細書に開示されたビデオインターホンに供給することができる。	而且，CPU 3D能够确认负载是连接到开启的三端双向可控硅开关元件、关断的三端双向可控硅开关元件还是“调光”状态的三端双向可控硅开关元件，从而 CPU可以肯定地识别设备的开启或关断或调光状态，并经由 IR驱动器 33和 IR发射器 13将这种数据馈送到未决的美国申请中披露的系统控制器、购物终端或视频对讲机。
すべての伝送LED13Aがスイッチでオンになり、それによって取付け技師または電気技師が、ライトガイド252を通過する伝播光（赤または黄または緑のような可視光）を目で見て識別しおよび／またはIR検出器でIR放射を検出することができるような具合に、本発明の好ましい実施形態は、上で言及されたビデオインターホンモニタまたはショッピング端末を含めてシステム制御装置中に組み込まれたケーブル識別プログラムを含む。	本发明的优选实施例包括嵌入到系统控制器（包括上面提到的视频对讲机监视器或购物终端）中的线缆识别程序，使得所有发射 LED 13A将开启，从而为安装者或电工提供视觉上看出或识别通过光导 252传播的光（可见光，诸如红或黄或绿）和 /或经由 IR检测器检测 IR辐射的能力。
図9Cのシステムディストリビュータ60Mのブロック図は、両方向データプロセッサ80を介したビデオインターホンモニタ82との間の両方通信を示し、両方向データプロセッサ80は、オーディオ、ビデオ、アラーム、ホームオートメーションおよびデータを両方向に処理して、特に、USBドライバ64を介しインターネット67を経由してPC66との間で、例えばオフィスにいるまたは他の場所の住宅所有者と通信することを可能にする。	图 9C的系统配电器 60M框图示出了视频对讲机监视器 82经由双向数据处理器 80之间的双向通信，双向数据处理器 80双向处理音频、视频、警报、家庭自动化和数据用于尤其实现 PC 66经由 USB驱动器 64之间的通信以及通过互联网 67与家庭主人例如在他的办公室或从其他地方通信。
一実施形態によると、あるデータパケットを処理するために適切なメモリ格納モードの選択は、受信したデータパケットをキューまたはフロー（例えば、VOIP、ストリーミングビデオ、インターネットブラウズセッション等）に分類すること、データパケット自体に含まれている情報、システムリソースが利用可能か否か等に基づいて為される（例えば、同時係属中の米国特許出願第13／038，266号（発明の名称：「ハードウェア／ソフトウェア複合型の転送メカニズムおよび転送方法」、代理人整理番号第MP3595号）を参照されたい。当該出願の明細書は、その内容を全て参照により本願に組み込むものとする）。	在一个实施方式中，基于对传入队列或流 (例如，VOIP、流式传输视频、互联网浏览会话等 )的数据分组的分类、包含在数据分组本身中的信息、系统资源的可用性 (例如，如共同未决申请美国 _____(名称为“Combined Hardware/Software Forwarding Mechanism and Method”，律师方案号 No.MP3595)中描述的那样，将其说明书通过引用全文合并于此 )等来做出对用于处理数据分组的合适存储器存储模式的选择。
年老いた猫	年迈的猫
老いぼれ．	老匹夫
年老いた父母．	年老的父母
老いぼれて耄碌している．	老朽昏庸
男も女も老いも若きも．	男女老少
老いぼれて耄碌している．	老朽昏庸
老いぼれて役に立たない．	老朽无能
男も女も老いも若きも．	男女老少
二つの老いへの挑戦	对两种“老化”的挑战
その老いた人はとても美しい。	那位年老的人非常美。
年老いて退職し郷里に帰る．	告老还乡
とんでもない嫌らしい老いぼれだ！	好一个讨厌的老货！
老いぼれ，まだ死んでいないのか！	你这个老家伙，还没有死？
彼は最近うんと老いぼれた．	他最近老迈多了。
老いぼれて物の役に立たない．	老迈不中用
鏡を見て年老いているのに気が付いた	我照镜子发现自己老了。
ある山奥に年老いた夫婦が住んでいました。	某个深山里住着年迈的老夫妇。
ある山奥に年老いた夫婦が住んでいました。	那个深山里住着一对老夫妇。
私は老いぼれ故に何も出来ぬ。	我一把老骨头，什么也干不了。
その記憶力が老いて弱っている。	记忆力随着变老而减弱。
人は老いると，本当に耄碌し，ぼけるものなのか？	难道人老了，就真地悖晦，糊涂？
年老いて，皮膚もすっかりつやがなくなった．	人老了，皮肤都干巴了。
慎重に年老いた病人に治療を行なった．	谨慎地对老年病人进行了治疗。
私はまだ老いていない，まだ何年か仕事ができる．	我还不老，还能干几年呢。
この老いぼれめ（まだ死なないのか→）とっとと死んでしまえ！	这个老梆子还不死！
老いぼれ，（私に干渉できるか→）大きなお世話だ！	老梆子，你管得着我吗！
この老いぼれは既に意余って力が足りません．	老朽已经力不从心。
この老いぼれめ，またおべっかを使いやがった．	这老家伙又溜须了。
母は年老いて，めったに外出しない．	母亲年纪大了，难得出门。
老いも若きもことごとく引き連れる．≒扶老携幼．	扶老挈幼((成語))
年老いて腰も徐々に曲がってきた．	人老了腰逐渐弯了。
彼はいつも「人間年老いると役に立たなくなる」と言う．	他总是说：“人一老就没有用处了。”
老いた雌豚が十数匹の子豚を生んだ．	老母猪一窝下了十几个崽。
年老いた母親は息子の帰りを今日か明日かと待ちに待っている．	老妈妈盼啊盼啊，盼着儿子回家来。
老いぼれめ，気でも狂ったかのように何を騒いでいるのか？	老家伙，疯疯癫癫地胡闹什么？
連れ合いに死なれてから，年老いた孤独な夫が取り残された．	自从老伴死了以后，就剩下他一个孤寡老头儿。
彼はこの不遇な道程を経て，ますます年老いてしまった．	经历了这一段坎坷的路程，他越发老了。
彼を嫌っている人は彼のことを憎らしい老いぼれだと言う．	讨厌他的人说他是可恶的老东西。
彼の家には年老いた母親，かあちゃん，それにたくさんの幼い子供がいる．	他家有老娘、婆娘和一大堆娃娃。
年老いた母が病気がちなことにかこつけ，しばらく休みを取る．	托词老母多病，暂行请假。
凶暴な年老いたオオカミは子羊を何匹かくわえて行った．	凶暴的老狼叼走了几只羊羔。
その年老いた道化師は、今でも彼のお気に入りの道化棒を大事に取っておいている。	那位年長的小丑到現在還是好好地保存着他最喜欢的道具
この老いぼれは才能がなく，（どうして再び出馬できようか？→）再び出馬することは到底できない．	老夫不才，怎能再出马呢？
あの年老いて病気がちの人さえ現在はすっかり変わってはつらつとしている．	连那个年老多病的人现在也都变得精精神神儿。
君たちから見れば私は年老いたでしょうね？もはや役に立たないと言いたいでしょうね？	你们看我年老了是吧？不中用了是吧？
（年齢は人を許さない→）年には勝てない，年をとって老いぼれるのはどうしようもない．	岁数不饶人((成語))
（歳月は人にとても非情なものだ→）歳月がたつのは速く人は老いやすい．≒岁月如流．	岁月不饶人((成語))
新年がやって来て，正月を迎えて忙しく，男も女も老いも若きもとても楽しそうである．	新年到，过年忙，男女老少喜洋洋。
国は年老いた肉体労働者に何年か安楽な生活を送ってもらうようにしている．	国家叫老年工人享几年清福。
村のどの家の娘も秀蘭ほどに年老いた親に対して孝行ではない．	村里谁家的女儿也没像秀兰对老人这么孝顺。
追い付く	追赶
夢追い人	追梦人
追いはぎ．	劫道的
死に追い込む．	整死
追いつき追い越そうとする精神．	赶超的精神
追い越し禁止！	不准超车！
党から追い出す．	清洗出党
追いはぎを働く．	拦路行劫
お前は追い詰められた。	你走投无路了。
疫病神を追い払う。	赶走瘟神。
私たちは追いつける。	我们能追上。
まだ追いつかれていない。	还没被追上。
彼が彼女を追い越す。	他追上了她。
しつこく追い回す。	坚持追赶。
亡命に追い込まれる．	被迫亡命
あくまでも追いすがる．	紧追不舍
彼はしばらく追いかけた．	他追了一程。
追いつ追われつする．	你追我赶
彼を追い出してくれ！	把他赶出去！
やっと追いついた．	好容易赶上了。
とうとう追いついた．	终于赶上了。
敵を追い払った．	把敌人赶走了。
需要に追いつかない．	跟不上需要
時流を追いかける．	赶浪头
激しく追いかける．	猛追猛赶
彼に追い出された．	被他撵了出来。
私は彼に追いつけない．	我撵不上他。
どうしても追いつけない．	无法企及
寂しさを追い払う．	驱除寂莫
あくまでも追いすがる．	尾追不舍
異性を追いかける．	追逐异性
我々は他の工場に追いつきかつ追い越した．	我们赶上并且超过了其他工厂。
しばらく追いかけたが，追いつかなかった．	赶了半天，没赶上。
彼はアメリカ選手を追い上げ，最後には追い越した．	他咬紧美国运动员，最后终于超过了。
真正面から目標を追い上げる，頑張って先頭に追いつく，急速に先端に追いつく．	迎头赶上((成語))
怪物に追いかけられた。	我被怪物追赶了。
頭の回転が追いつかない。	我的思维跟不上。
友人に追いつかなければならない。	我必须追上朋友。
君のことを追い抜きたくない。	我不想超过你。
追い掛け回してすみません。	不好意思紧追不放。
私は虫を追い払った。	我把虫子赶跑了。
ウサギがカメを追い抜いた。	兔子超过了乌龟。
彼が私を追い越している時に	他在超越我的时候
私達はそれらを追い求めます。	我们在追求那些。
追い詰めて彼を逮捕しろ。	穷追不舍的逮捕他。
彼らは、私を追い出しました。	他们把我赶出去了。
彼はそこから追い出された。	他被赶出那儿了。
彼は鳴子で鳥を追い払った。	他拿着拍子赶走了鸟。
家からゴキブリを追い出したい。	想把蟑螂赶出家里。
とにかく夢を追い続けたい。	无论如何我都想继续追逐梦想。
真正面から目標を追い上げる，頑張って先頭に追いつく，急速に先端に追いつく．	迎头赶上((成語))
真正面から目標を追い上げる，頑張って先頭に追いつく，急速に先端に追いつく．	迎头赶上((成語))
真正面から目標を追い上げる，頑張って先頭に追いつく，急速に先端に追いつく．	迎头赶上((成語))
そこで本実施形態では、エラーレートに追従して送信部162の単位時間当たりの送信符号量である無線伝送レートと、ビデオエンコーダ161の単位時間当たりの発生符号量である画像伝送レートをそれぞれ制御するにあたり、画像伝送レートを下げる場合には第1の応答時間でその制御が行われ、画像伝送レートを上げる場合には第1の応答時間より長い第2の応答時間でその制御が行われるものとしている。	在这点上，在本实施例中，在基于误码率来控制作为发送部分 162每单位时间的发送代码量的无线传输率和作为视频编码器 161每单位时间的产生代码量的图像传输率时，当降低图像传输率时，将其控制在第一响应时间之内，而当提高图像传输率时，将其控制在比第一响应时间更长的第二响应时间之内。
すなわち、無線送信部16内の送信制御部163は、無線通信品質が低くなったことに追従して無線伝送レートを低下させたとき、高い画像伝送レートを維持したままでは通信容量が足りなくなり画像エラーが発生する危険があるので、この場合には画像伝送レートを直ぐに（第1の応答時間で）下げ、無線通信品質が改善された場合には、無線伝送レートが画像伝送レートより高い期間が一定期間連続した時点で画像伝送レートを上げる。	换句话说，由于担心在随着无线通信质量的下降而降低无线传输率时，在图像传输率保持为高时通信容量变得不足从而引起图像误差，无线发送部分 16的发送控制部分 163在此情况下立即 (第一响应时间 )降低图像传输率，而在改进无线通信质量时，在其中无线传输率高于图像传输率的时段已经持续了某段时间的某个时间点时，提高图像传输率。
（鉄砲が先頭に立つ鳥を撃つ→）先頭に立つ人物はしばしば人から追い落とされる．	枪打出头鸟((成語))
（鉄砲が先頭に立つ鳥を撃つ→）先頭に立つ人物はしばしば人から追い落とされる．	枪打出头鸟((成語))
オイオイと泣く．	放声大哭
彼女は悲しんでおいおい泣いている．	她伤心地啼哭着。
おいおい，君のそのニュースは結局のところ確かなのかね？	喂，你这个消息到底可靠不可靠？
お前という男は1人の娘のためにおいおい泣いて，人に笑われるよ！	你这个人，为一个姑娘哭哭啼啼，不怕旁人笑？
その娘はおいおい泣きながら母親のところへ飛んで行った．	那个女孩子哭哭啼啼地奔到母亲眼前。
君，おいおいとあちらの状況をよく知るようにしなさい．	你慢慢熟悉一下那里的情况。
新しく来たばかりだからまだ慣れていないが，おいおい慣れっこになればそれでいいんだ．	新来乍到还不惯，慢慢地皮拉下来就好了。
彼女は思わずオイオイと泣きだした．	她禁不住呜呜地哭起来。
オイオイと泣く．	放声大哭
彼女は思わずオイオイと泣きだした．	她禁不住呜呜地哭起来。
追い付く	追赶
夢追い人	追梦人
追いはぎ．	劫道的
死に追い込む．	整死
追いつき追い越そうとする精神．	赶超的精神
追い越し禁止！	不准超车！
党から追い出す．	清洗出党
追いはぎを働く．	拦路行劫
お前は追い詰められた。	你走投无路了。
疫病神を追い払う。	赶走瘟神。
私たちは追いつける。	我们能追上。
まだ追いつかれていない。	还没被追上。
彼が彼女を追い越す。	他追上了她。
しつこく追い回す。	坚持追赶。
亡命に追い込まれる．	被迫亡命
あくまでも追いすがる．	紧追不舍
彼はしばらく追いかけた．	他追了一程。
追いつ追われつする．	你追我赶
彼を追い出してくれ！	把他赶出去！
やっと追いついた．	好容易赶上了。
とうとう追いついた．	终于赶上了。
敵を追い払った．	把敌人赶走了。
需要に追いつかない．	跟不上需要
時流を追いかける．	赶浪头
激しく追いかける．	猛追猛赶
彼に追い出された．	被他撵了出来。
私は彼に追いつけない．	我撵不上他。
どうしても追いつけない．	无法企及
寂しさを追い払う．	驱除寂莫
あくまでも追いすがる．	尾追不舍
異性を追いかける．	追逐异性
我々は他の工場に追いつきかつ追い越した．	我们赶上并且超过了其他工厂。
しばらく追いかけたが，追いつかなかった．	赶了半天，没赶上。
彼はアメリカ選手を追い上げ，最後には追い越した．	他咬紧美国运动员，最后终于超过了。
真正面から目標を追い上げる，頑張って先頭に追いつく，急速に先端に追いつく．	迎头赶上((成語))
怪物に追いかけられた。	我被怪物追赶了。
頭の回転が追いつかない。	我的思维跟不上。
友人に追いつかなければならない。	我必须追上朋友。
君のことを追い抜きたくない。	我不想超过你。
追い掛け回してすみません。	不好意思紧追不放。
私は虫を追い払った。	我把虫子赶跑了。
ウサギがカメを追い抜いた。	兔子超过了乌龟。
彼が私を追い越している時に	他在超越我的时候
私達はそれらを追い求めます。	我们在追求那些。
追い詰めて彼を逮捕しろ。	穷追不舍的逮捕他。
彼らは、私を追い出しました。	他们把我赶出去了。
彼はそこから追い出された。	他被赶出那儿了。
彼は鳴子で鳥を追い払った。	他拿着拍子赶走了鸟。
家からゴキブリを追い出したい。	想把蟑螂赶出家里。
とにかく夢を追い続けたい。	无论如何我都想继续追逐梦想。
そのような場合、プログラム330は、表示するルータのリストに、タスク・データベースから得られる次ホップ・ルータの名称を追加し、その次ホップ・ルータは欠落しているものとしてマークする（ステップ854）。	 在这种情况下，程序 330把来自任务数据库的下一跳路由器的名称添加到路由器的列表中以便显示，并把该下一跳路由器标记为缺失 (步骤 854)。
彼は大官になって，一時飛ぶ鳥を落とす勢いであった．	他当了大官，显赫过一时。
一方、被写体距離推定手段22において、被写体距離が無限遠と推定された場合（ステップS4、No）、マトリックス選択手段17は、近接距離でベストフォーカスとなるように撮像レンズ14が設計されているG2の画像データに対して、無限遠での解像度復元を実施するための解像度復元用マトリックスminf（G2）を選択する。	另一方面，在被摄体距离推测单元 22中，当推测为被摄体距离为无穷远时 (步骤S4，否 )，矩阵选择单元 17对于将临近距离设定为最佳焦点的摄像透镜 14的 G2的像素数据，选择用于实施无穷远处的解析度复原的解析度复原用矩阵 minf(G2)。
このように分析フィルタリングを再帰的に繰り返すことにより、空間周波数の低い帯域の係数データをより小さな領域に追い込むことができる。	这样递归地重复分析滤波能够把低空间频带中的系数数据分成更小的区域。
このように分析フィルタリングを再帰的に繰り返すことにより、空間周波数の低い帯域の係数データをより小さな領域に追い込むことができる。	当如上所述递归重复分析滤波时，低空间频率带中的系数数据可以被分离为更窄的区域。
私の成績は先生の要求からまだ懸け離れている．	我的成绩离老师的要求还有距离。
自分が先生の要求からどれほど懸け離れて劣っているかということを今ようやく認識できた．	现在我才认识到，自己距离老师的要求还差得很远。
これは彼が一生懸けて追求した事業である．	这是他一生追求的事业。
時流を追いかける．	赶浪头
激しく追いかける．	猛追猛赶
異性を追いかける．	追逐异性
一歩も休まず追いかける．	一步不停((成語))
警察が泥棒を追いかける．	警察追小偷。
追いかける速度が遅すぎる．	追的速度太慢了。
君は先を行け，私は後ろから追いかける．	你在前面走，我在后面赶。
先進的なものを学び，先進的なものを追いかける．	学先进，赶先进
あなたはどのスポーツ選手の情報を追いかけるつもりですか？	你打算追踪关注哪项运动选手的消息？
現在の「流行を追いかける人」はただ新しさをやかましく言うが，規律のあるものは気にかけない．	如今的“潮人”们只讲新，并不在乎规律的。
追い風で下りの速度は速い．	顺风下水速度快。
追い風を受け流れに乗って，船は1日で到着した．	风顺水也顺，船一天就到了。
今日は追い風だから，船は特別速く走る．	今天顺风，船走得特别快。
1隻の大きな船が深い緑の水面を追い風を受けて動いて行く．	一艘大船在油绿的水面上顺风驶去。
資金・材料・労働力が追いつかない．	资金、材料、劳力跟不上。
民族の危難を顧みず金銭を追い求める．	不顾民族危难而追逐钱财。
現在は学歴を追い求めて教育にお金をかける人は多い。	现在追求学历而在教育上花钱的人很多。
（老木などが）たくましく伸びている．	苍劲挺拔((成語))
これは樹齢千年の老木で，たいへんな年代を経ている．	这是千年老树，古得很。
このコノテガシワの老木は屹然として城壁の根元にそそり立っている．	这株古柏屹然挺立在城墙脚下。
その老木の上の半分はこずえが1本残っていて生きているが，下の半分はすっかり空洞である．	那老树上半截剩了一个梢儿活着，下半截都空了。
その老木の上の半分はこずえが1本残って生きているが，下の半分はすっかり空洞になっている．	那老树上半截剩了一个梢儿活着，下半截都空了。
そこで、設定画面Sの切り替わったときに定着温度制御を再開するか否か判断するならば、時点TP2と、時点TP2から更に、1枚の設定画面S分（所要時間T2分）遡った時点TP4（第2時点に相当）の間に位置する設定画面Sの切り替わりの際に、定着温度制御を再開すればよい。	因此，如果判断为在切换设定画面 S时重启定影温度控制，则在位于时间点TP2和时间点 TP4(相当于第二时间点 )之间的设定画面 S切换时，重启定影温度控制即可，所述时间点 TP4是从时间点 TP2进一步追溯 1幅设定画面 S(所需时间 T2的量 )的时间点。
やはりステップ550において、その後続のバックアップ経路に切り替えることによってdが回復されるとき、まず、いずれかの解放された容量が使用され得るかどうかを検査して、次いで、dの新しいバックアップ経路の全域で任意の必要な容量をリンクに追加することによって、必要とされる新しい容量Cp＋1が計算される。	此外，在 550步骤，当 d通过切换到后续的备用路径被恢复时，计算所需的新的容量 Cp+1，这是通过如下方式来完成的，即首先检查是否有任何释放的容量可用，然后添加任何必要的容量到跨 d的新备用路径的链路上。
口でしーっしーっと言い雌鶏を追い払った．	嘴里嘘嘘地把母鸡撵走。
駟も舌に及ばず，いったん言葉を口に出したら4頭立ての馬車でも追いつかない．	驷不及舌((成語))
（いったん口に出した言葉は4頭立ての馬車でも追いつけない→）（いったん口に出したら）取り返しがつかない．	［一言既出，］驷马难追((成語))
オイルタンク車，タンクローリー．	油罐车
追い越し禁止！	不准超车！
彼が私を追い越している時に	他在超越我的时候
君の成績は彼を追い越した．	你的成绩迈过他去了。
我々は他の工場に追いつきかつ追い越した．	我们赶上并且超过了其他工厂。
乗用車がさっとトラックを追い越した．	小汽车很快就超过了卡车。
彼はぐっとダッシュして，前の人を追い越した．	他一［个］猛劲儿，就超过了前边的人。
彼はアメリカ選手を追い上げ，最後には追い越した．	他咬紧美国运动员，最后终于超过了。
前の車がのろのろしているので，追い越して行きましょう．	前边这辆车开得很慢，咱们抢过去吧。
停車している路線バスに近づいた時は、その後方で一時停止し追い越してはならない。	在接近停着的路线巴士的时候，必须在巴士后方暂时停下而不能超车。
彼が彼女を追い越す。	他追上了她。
彼はぴったりついてくる後続車が追い越すように左に寄った。	他向左靠是为了让后面紧跟的车可以超过去。
我々は必ず先進的水準に追いつき追い越すことができる．	我们一定能赶超先进水平。
1年の間に全国農業発展要綱の定めた目標に到達し，2年の間に淮河・秦嶺・白竜江以南の生産高を追い越す．	一年上纲、两年过江
敵を否応なく投降させる，敵を投降するように追い込む．	逼使敌人投降。
彼女は私を追い出して引っ越しさせる．	她撵我搬家。
（人を追いつめて幹が横に曲がった首吊り用の木を捜させる→）人を自殺に追いやる．	逼人找歪脖树
どうやったら、パソコンからグレムリンを追い出せるのだろう。	怎么样才能把技术小妖精从电脑里赶出去。
あなたがしたくない事を，いつも他人を追い回してやらせる．	你不愿做的事，老支别人做。
この判断において、不可能と判断された場合、即ち、残りのバッファ量と現在の転送速度とで転送されるデータ量とでは、再生速度に追いつかないという場合には、制御部106は、再生部112に再生させるコンテンツを、ストリーミング再生しているコンテンツから、記憶部110に記憶された挿入コンテンツ1102に切替える。	如果在该确定中确定为不能，即剩余缓冲数据量和以当前传输速度传输的数据量不能赶上再现速度的情况，控制单元 106将要由再现单元 112再现的内容从正在流传输的内容切换到在存储单元 110中存储的插入内容 1102。
死に追い込む．	整死
敵を否応なく投降させる，敵を投降するように追い込む．	逼使敌人投降。
困った立場を脱することができないように彼を追い込むな．	别让他下不了台。
このように分析フィルタリングを再帰的に繰り返すことにより、空間周波数の低い帯域の係数データをより小さな領域に追い込むことができる。	这样递归地重复分析滤波能够把低空间频带中的系数数据分成更小的区域。
このように分析フィルタリングを再帰的に繰り返すことにより、空間周波数の低い帯域の係数データをより小さな領域に追い込むことができる。	当如上所述递归重复分析滤波时，低空间频率带中的系数数据可以被分离为更窄的区域。
この老いぼれは既に意余って力が足りません．	老朽已经力不从心。
草木が生い茂っている．	草木繁茂
草木が勢いよく芽吹く．	草木怒生
山田さんの本社連絡先	山田先生的公司联络地址
山の上には草木が生い茂っている．	山上草木郁郁。
私はこれから先もあなたの生徒のつもりです。	我打算从今以后还是您的学生。
紫式部と清少納言の人生	紫式部和清少纳言的人生。
何はさておき先に若干の生活用品を備えつける．	先设备一些生活用品。
春になると，草木が勢いよく生い茂る．	春天一到，草木蓬勃滋生。
さて、人生について考えるために時間を割きなさい。	那么，请分割点时间出来考虑一下人生。
彼は生涯地の果てに流浪し，旅先の住まいも苦労に満ちたものである．	他一生流落天涯，旅次艰辛。
張先生は原籍は広東で，寄宿先は北京だ．	张老师原籍是广东，寄籍是北京。
先に述べたように、レプリカ生成部219では、符号ビットのLLRに応じてその信頼性に比例したソフトレプリカが生成される。	如上所述，在复本生成器 219中，与编码比特的 LLR的可靠度成比例地生成软信息。
移行元ストレージサブシステム100aから移行先ストレージサブシステム100bへの移行が生じる。	将发生从源存储子系统 100a到目标存储子系统 100b的转移。
0078 （b） 切替えが生じる前に、移行先ストレージサブシステム100bはFC／FCoEスイッチとして作用する。	(b)在发生切换之前，目标存储子系统 100b用作 FC/FCoE交换机。
606で、連絡先情報に関する一時的条件を受信または生成することができる。	在 606处，可接收或产生针对联系人信息的时间条件。
この二三年大学生は値打ちが下落し，就職先は末端の方に傾いた．	这两年大学生掉价，分配面向基层。
これは後にも先にも，生まれて初めて珍しいものにお目にかかって，富貴な人の生活を見た．	这算是我开天辟地以来，第一次开洋荤，看到了富贵者的衣食住行。
条件が生じると、連絡先リストから連絡先情報216を保存および/または除去し、アーカイブメモリ内に格納することができる。	一旦条件发生，联系人信息216就可从联系人列表归档和 /或移除，并存储在归档存储器中。
さらに、この方法は、連絡先リスト内に連絡先情報を維持することに関する一時的条件を受信または生成し、一時的条件の発生に少なくとも部分的に基づいて、連絡先リストから連絡先情報を除去することを含むことができる。	此外，所述方法可包含接收或产生用于在联系人列表中维持联系人信息的时间条件，并至少部分地基于所述时间条件的发生而从联系人列表中移除联系人信息。
先ほど、山田さんというお客様が席を予約されました。	刚才，有一位叫做山田先生/小姐的客人预定了位置。
先々月のご請求に対して未払い分が発生している模様です。	上个月的账单好像有未支付的部分。
（秋に生えかわる鳥獣の羽毛・細い毛の先→）極めて小さなもの．	秋毫之末((成語))
（秋に生えかわる鳥獣の羽毛・細い毛の先→）極めて小さなもの．	秋毫之末((成語))
ユーザは、連絡先の誕生日に毎年連絡先に送信されるべき個人用の誕生日のお祝いの言葉の下書きを作成することができる。	用户可起草将在每年该联系人的生日那天发送给该联系人的个性化生日祝贺。
基準信号生成部205は、先と同様に相関演算部2063が相互相関値の計算に用いるための一方の系列を生成するが、出力信号の時間長は先の例に比べて2倍となっている。	类似于上述示例，信号产生器 205产生由相关器 206使用的一个序列以计算互相关值，输出信号的时间长度相比较于上述示例是其两倍。
管理機器200は、一時的条件の発生まで、モバイル装置の連絡先リスト(例えば、アドレス帳アプリケーションおよび/または連絡先オーガナイザの一部)内に連絡先情報216を維持することができる。	管理设备 200可在移动装置的联系人列表中维持联系人信息 216(例如，地址簿应用程序和 /或联系人管理器的一部分 )，直到发生时间条件为止。
そして、ルーティング部27は、図1に示すように、次のホップ先である通信装置Dのアドレス「D」を1ホップ宛先アドレス、自装置Aのアドレス「A」を1ホップ送信元アドレスとして、これら1ホップ宛先アドレス及び1ホップ送信元アドレスを通信フレーム生成部22により生成されたセキュアな通信フレームに付与して、1ホップ通信フレームを生成する。	而且，路由部 27，如图 1所示那样，把作为下一跳目的地的通信装置 D的地址“D”设为 1跳目的地地址，把自身装置 A的地址“A”设为 1跳发送源地址，把这些 1跳目的地地址及 1跳发送源地址附加到由通信帧生成部 22所生成的安全通信帧中，来生成 1跳通信帧。
何れかのタイトルが選択された際、再生装置は、選択されたカレントタイトルに対応するもののプレイリストアクセス情報により指定されたプレイリストの再生を、アプリケーションからの再生指示を待つことなく開始し、プレイリスト再生の終了よりも、バイトコードアプリケーション実行が先に終了した場合、プレイリストの再生を継続して行う。	在选择了某个标题时，再生装置不等待来自应用的再生指示而开始由对应于所选择的当前标题的播放列表访问信息指定的播放列表的再生，在字节码应用执行比播放列表再生的结束先结束的情况下，继续进行播放列表的再生。
つまり、走査キャリッジに振動が生じるとミラーの間の光軸が狂ってしまうことで読み取り性能が低下して、最終的には原稿読み取り画像が劣化するという問題が生じるが、上記の実施形態ではそのような問題が生じにくい。	即，如果扫描托架产生振动则会产生反射镜之间的光轴偏位从而读取性能降低，最终原稿读取图像劣化的问题，但是，在上述实施方式中难以产生这种问题。
通常動作期間K2において、DAC160では、P相時のある傾きをもった参照信号SLPADCが生成される。	在正常操作时间段 K2中，DAC 160生成具有 P-相位模式中斜率的参照信号 SLP_ADC。
一例では、移行元ストレージサブシステム100aから移行先ストレージサブシステム100bへと移行が発生する。	在一个实例中，发生从源存储子系统100a到目标存储子系统 100b的转移。
東日本大震災の発生を受けTOPIX先物が大幅に下落し、サーキットブレーカーが発動された。	东日本大地震发生后，东京股价指数期货大幅下跌，所以股市中的下限条款被启用。
今日の幸福な生活は無数の先烈の鮮血によってあがなったもので，何者かが恩恵として恵んだものではない．	今天的幸福生活是无数先烈的鲜血换来的，不是什么人恩赐的。
（羊の肉をまだ口に入れない先に体全体が生臭くなる→）うまい汁を吸わない先に悪い評判を招く．	羊肉不曾吃，空惹一身膻。((ことわざ))
（3）更に、フレーム生成機能にて該当する転送先ONUに設定したPort−IDを含むGEMヘッダを生成し、（4）当該GEMヘッダを受信パケットに付与して、イーサネットパケットをGEMフレームとしてカプセリングする。	(3)进而，通过帧生成功能生成包括对相应的转发目的地 ONU设定的 Port-ID的 GEM头； (4)将该 GEM头赋予给接收包，将以太网包封装为 GEM帧。
また、通信フレーム生成部22は、生成したセキュアな通信フレームに、時変パラメータ以外に、自身から宛先装置へのマルチホップ伝送にかかると予想される距離（ホップ数）を含むようにしても良い。	另外，通信帧生成部 22，也可以构成为，在所生成的安全通信帧中，除了时变参数以外，还包含从自身向目的地装置的多跳传送中预测需要的距离 (跳数 )。
テレビ電話画像12は、相手先のVC装置2から取得したデータに基づいて生成された画像であり、テレビ電話画像13は、自身のVC装置1のカメラ1Rから取得したデータに基づいて生成された画像である。	可视电话画面 12是基于从对应方的 VC设备 2获得的数据生成的画面，并且可视电话画面 13是基于从用户自己的 VC设备 1的相机 1R获得的数据生成的画面。
小麦の先物に損失が生じているものの、買い辛抱を続け相場の反転を待っている。	虽然小麦期货正在亏损，但还是保持耐心等待着行情的逆转。
私にとっては幸福に生きるほうが死を先延ばしにするより大切なのです。	对我来说可以幸福的活着比去延缓死亡来说更为重要。
先ほどご入金を確認しました。行き違いになってしまい大変失礼しました。	刚才已经确认收款。很抱歉产生了差错。
厳格な父からはよい息子ができ，慈愛深い母からは手先の器用な娘が生まれる．	严父出好子，慈母出巧女。((ことわざ))
厳格な父からはよい息子ができ，慈愛深い母からは手先の器用な娘が生まれる．	严父出好子，慈母出巧女。((ことわざ))
太陽の光と雨露がなければ，草木や万物を生長させることはできない．	没有阳光雨露，就没有草木万物的滋长。
送信先である画像形成装置のセキュリティ設定に基づいてバナーページの内容を生成することによって、利用者側でその都度セキュリティ設定をすることなく、出力先の設定に基づいたバナーページを生成することができる。	根据作为发送端的图像形成装置的安全设定而生成标题页的内容，从而在利用者侧不用每次进行安全设定，就可以生成基于输出端的设定的标题页。
パケット処理回路120と転送先決定回路130と内部バス140にクロック信号を供給するクロック生成部CL1〜CL4に低クロック信号HLを生成させ、外部バス500および送受信処理回路310にクロック信号を供給するクロック生成部CL5〜CL7に高クロック信号HHを生成させて動作させる状態を第2の動作モードとする。	将使向数据包处理电路 120和传输目的地决定电路 130以及内部总线 140供给时钟信号的时钟生成部 CL1～ CL4生成低时钟信号 HL、使向外部总线 500和收发处理电路 310供给时钟信号的时钟生成部 CL5～ CL7生成高时钟信号 HH来进行动作的状态作为第 2动作模式。
ステップS1104では、MFP101のCPU301は、ステップS1102でのイベント通知先管理テーブルに対する登録更新処理の結果と、ステップS1103で決定した送信先アドレスとを基に、図5に示すイベント通知依頼の返信パケットを生成する。	在步骤 S1105，CPU 301经由网络 I/F 309和 LAN 110向步骤 S1103中确定出的PC 103的 IP地址发送步骤 S1104中生成的应答包，由此本处理完成。
例えば、上記各実施の形態では、コアデータ42とともにヘッダ41も転送先の画像形成装置へ書き込んでいるが、ヘッダ41は、転送先の画像形成装置が自ら生成し書き込むようにしてもよい。	例如，在上述各实施方式中，头部 41也与核心数据 42一起被写入到传送目的地的图像形成装置，但传送目的地的图像形成装置也可以自己生成头部 41并写入。
クロック生成部CL1は、上述した中継処理ボード100の転送先決定回路130にクロック信号を供給し、転送先決定回路130は、供給されたクロック信号に同期して動作する。	时钟生成部 CL1向上述中继处理板 100的传输目的地决定电路 130内供给时钟信号，传输目的地决定电路 130与供给的时钟信号同步动作。
機器200は、送信先として予め設定されたネットワーク設定情報（送信先情報）に基づき、生成した通知情報を機器管理装置100に送信する。	该装置 200基于预先设定的作为发送目标的网络设定信息 (发送目标信息 )，将生成的通知信息传送到装置管理设备 100。
メモリ208は、メモリ内に連絡先情報を保持することに関する一時的条件を受信または生成するように構成される連絡先管理モジュール212をさらに含むことができる。	存储器 208可进一步包含联系人管理模块 212，所述联系人管理模块 212经配置以接收或产生用于将联系人信息维持在存储器内的时间条件。
先日お会いした医師です。	我是前几天见面的医生。
先生が生徒を教育する．	老师教育学生。
先生が学生に試問する．	老师考问学生。
先生が生徒を教え導く．	老师训导学生。
先生が受け持っている生徒さんは何人くらいですか？	老师管着多少名学生？
先生は規律を守らない生徒を批判した．	老师批评了不守纪律的学生。
先生は学生一人々々をよく知っていなければならない．	老师要熟悉每个学生。
得意先への手土産	给老客户的简单礼物
お先にどうぞ，おじいちゃん！	你先去吧，老爷爷！
週の前半は得意先を訪ねて回ります。	前半周在奔走拜访老客户。
得意先の会社名くらい覚えてください。	请至少记住老客户的公司名。
お盆にオートバイで長崎に帰省する予定です。	我盂兰盆节准备骑摩托车回长崎老家。
先ほどの人は，彼女の古い友人だ．	刚才那个人，就是她的老朋友。
新聞が送られて来ると，彼はいつも我先に読む．	报一送来，他老抢着看。
張先生は原籍は広東で，寄宿先は北京だ．	张老师原籍是广东，寄籍是北京。
得意先回りで、靴が二ヶ月弱でだめになった。	因为到处走访老客户，所以鞋子不到两个月就坏了。
その年，西太后は西洋人とぐるになり，庶民を弾圧した．	当年，西太后和洋人穿一条连裆裤，一块镇压老百姓。
この年寄りは祖国に帰って，やっと落ち着き先を得ることができた．	这位老人回到祖国，才找到了归宿。
先にお宅に行ってから張さんの所に行くと道順が悪い．	要先去你家再去找老张就不顺路。
（青山はいつまでも老いない，緑の水はいつまでも存する→）長い時間が経過しても永久に存在する，これから先十分時間がある．	青山不老，绿水长存。((成語))
ご利用頂いたすべてのお客様をお得意先として充実したサービスを提供します。	把所有使用本产品的顾客作为老顾客来提供充实的服务。
彼は教師になるのは決して難しくなく，口先だけですぐできると感じた．	他觉得讲课当老师并不艰难，全凭嘴皮子，一动口就会。
この老先生は話し方ややり方が少し古臭い．	这位
君は本当に大したものだ，この老先生まで引っ張って来た．	你可真有本事，把这位
老先生の言われることは全くそのとおりで，よいことを伺いました．	老先
この非常に高齢な老先生は60年にわたって教師として生活し，弟子たちが天下に満ちあふれている．	这位年近耄耋的
この問題は呉先生の所に行って教えを請わねばならない．	这个问题要去请教吴
（あなた様に）ちょっとお尋ねしますが，公園に行くにはどう行ったらよろしいですか？	请问
人生の大先輩	人生中的
革命の大先輩．	革命
前王朝の遺老．	胜朝遗老
彼は教育界の大先輩である．	他是教育界的
彼は言語学界の大先輩で，一生涯基礎中国語を教えた．	他是语言界的
先人の闘争経験は，若い世代にとっては計り知れないほど役に立つ．	老前
おいしい．	受吃
おいしいです。	很好吃。
おいしい？	好吃吗？
おいしいです。	好吃。
食事がおいしい。	饭很好吃。
おいしいでしょ？	很好吃吧？
「おいしい！」「何が？」	“好吃！”“什么东西？”
おいしいですね。	很好吃啊。
なかなかおいしい。	非常好吃。
おいしいですね。	很好吃呢。
おいしい食べ物	好吃的食物
とってもおいしい。	特别好吃。
ビールがおいしい。	啤酒好喝。
食べ物もおいしいです。	食物也很美味。
とてもおいしいです	非常好吃。
とてもおいしいです。	很好吃的。
食物がおいしい．	食物鲜美
おいしい水の出る井戸．	甜水井
美味しいわ。	好好好吃啊。
美味しいです。	好吃。
美味しいです。	很好吃。
美味しいわ。	真好吃啊。
晩御飯、おいしいもの食べた？	晚饭好吃吗？
おいしいかどうかわかりません。	不知道是否好吃。
おいしいちまきを食べてね。	要吃好吃的粽子哦。
私はおいしいものが食べたいです。	我想吃好吃的。
私の母がおいしいと言っています。	我妈妈说好吃。
それはさっぱりしておいしい。	那个又清爽又好吃。
それはとてもおいしいです。	那个非常的好吃。
このお店は、魚がおいしいです。	这个店的鱼很好吃。
ビールはワインよりおいしい。	啤酒比葡萄酒更好喝。
おいしい豚カツレツのお店	好吃的炸猪排的店
メキシコ料理はとてもおいしい。	墨西哥料理很好吃。
メキシコ料理はおいしい。	墨西哥料理很好吃。
今日ね、おいしいランチを食べたの。	今天吃了美味的午餐。
どこの店が一番おいしいですか。	哪家店最好吃？
野菜が新鮮でおいしい。	蔬菜新鲜好吃。
この料理おいしいですね。	这道菜很好吃呢。
味はあっさりしていておいしいです。	味道很清爽好吃。
この料理は、とてもおいしいです。	这道菜很好吃。
このりんごは割とおいしいです。	这个苹果意外的很好吃。
この肉じゃがはとてもおいしい。	这个土豆炖肉很好吃。
おいしいりんごがあります。	有好吃的苹果。
野菜は炒めて食べるとおいしい。	蔬菜炒了之后会好吃。
お母さんの餃子はおいしいです。	妈妈做的饺子好吃。
おいしい日本食ですね。	很好吃的日本料理啊。
おいしい日本食ですね。	是美味的日本菜啊。
この料理は本当においしい．	这个菜真好吃。
このカキは甘くておいしい．	这种柿子甘甜可口。
新鮮なレイシは本当においしい！	鲜荔枝可好吃呢！
美味しいわ。	好好好吃啊。
美味しいです。	好吃。
美味しいです。	很好吃。
美味しいわ。	真好吃啊。
それは美味しい。	那很好吃。
これは美味しい。	这个很好吃。
それは美味しい。	那个很好吃。
美味しいですか？	好吃吗？
酒は美味しい。	酒很好喝。
そりゃ美味しいわ。	那个真好吃啊。
食べ物も美味しいです。	食物很好吃。
これは美味しいですか。	这个好吃吗。
餃子は美味しいですか？	饺子好吃吗？
台湾の水は美味しい？	台湾的水好喝吗？
それは美味しいです。	那个很好吃。
それはとても美味しい。	那个特别好吃。
その食事が美味しい。	那顿饭很好吃。
この水は美味しい。	这水很好喝。
紅茶が美味しい。	红茶很好喝。
これは美味しいですか？	这个好吃吗？
これは美味しいのですか。	这个好吃吗。
それは美味しいのですか。	那个好吃吗？
これがとても美味しい。	这个非常好吃。
これは美味しいです。	这个很美味。
大変美味しいです。	特别好吃。
川の水が美味しい。	河里的水很好喝。
飲み物が美味しい。	饮料很好喝。
食べ物が美味しい。	食物很美味。
キムチが美味しいです。	泡菜很美味。
とても美味しいです。	很好吃。
このケーキは美味しい。	那个蛋糕很好吃。
日本酒は美味しい。	日本酒很好喝。
日本のラーメンは美味しいです。	日本的拉面好吃。
どの肉料理が美味しいですか？	哪种肉食好吃？
和食は美味しいですよね。	日本菜很好吃啊。
私は味噌汁も美味しいと思う。	我觉得味增汤也好喝。
中国料理は美味しいです。	中国菜很好吃。
美味しいお酒を嗜んできました。	去喝了美酒。
この瓶のお酒は美味しい。	这个瓶子的酒很好喝。
最も美味しいレストラン	最好吃的饭店
生ビールの美味しいお店	生啤酒好喝的店
それはとても美味しいです。	那个非常的好吃。
庭で取れたトマトは美味しい。	在院子里摘的西红柿好吃。
この料理美味しいですね。	这道菜很好吃呢。
これはとても美味しいです。	这个非常好吃。
これはとても美味しいです。	这个非常的好吃。
あなたの弁当はとても美味しい。	你做的便当很好吃。
美味しいものだけ食べます。	我只吃好吃的东西。
美味しい料理を食べたい。	我想吃好吃的菜。
新発売の方が美味しい。	新发售的那个更好吃。
